村里,2024-2022,2024民眾黨,2022村里長得票,2024投票數,2024選舉人數,2024投票率,里長姓名,里長政黨
南投縣中寮鄉中寮村,-316,60,376,391,583,0.7,黃文安,無
南投縣中寮鄉內城村,-216,46,262,281,427,0.7,廖增堆,無
南投縣中寮鄉八仙村,-357,104,461,522,729,0.7,江輝能,無
南投縣中寮鄉和興村,-311,55,366,402,600,0.7,孫瑞娟,無
南投縣中寮鄉崁頂村,-225,60,285,310,454,0.7,廖俊松,無
南投縣中寮鄉廣福村,-263,52,315,315,464,0.7,洪長湖,無
南投縣中寮鄉廣興村,-119,92,211,515,743,0.7,洪明享,無
南投縣中寮鄉復興村,-147,32,179,185,260,0.7,官玉瑛,無
南投縣中寮鄉永和村,-173,70,243,347,486,0.7,吳順興,無
南投縣中寮鄉永平村,-472,202,674,1144,1609,0.7,吳炎泉,無
南投縣中寮鄉永福村,-333,168,501,882,1274,0.7,張彩琴,無
南投縣中寮鄉永芳村,-198,52,250,308,430,0.7,曾盟富,無
南投縣中寮鄉清水村,-193,99,292,532,833,0.6,李春發,無
南投縣中寮鄉爽文村,-132,58,190,304,439,0.7,廖文權,無
南投縣中寮鄉福盛村,-215,56,271,427,630,0.7,李慶忠,無
南投縣中寮鄉義和村,-493,145,638,715,1008,0.7,廖先前,無
南投縣中寮鄉龍安村,-215,68,283,441,638,0.7,廖振添,無
南投縣中寮鄉龍岩村,-226,65,291,434,605,0.7,黃振國,無
南投縣仁愛鄉中正村,-198,72,270,542,851,0.6,石金水,中國國民黨
南投縣仁愛鄉互助村,-302,152,454,799,1141,0.7,梁文峯,中國國民黨
南投縣仁愛鄉力行村,-220,25,245,273,493,0.6,白明惠,無
南投縣仁愛鄉南豐村,-258,107,365,814,1225,0.7,曾子郡,無
南投縣仁愛鄉大同村,-850,151,1001,1045,1560,0.7,謝戎彥,中國國民黨
南投縣仁愛鄉德鹿谷村,-139,52,191,329,603,0.5,邱清文,無
南投縣仁愛鄉新生村,-122,48,170,303,384,0.8,鄭志誠,中國國民黨
南投縣仁愛鄉春陽村,-538,86,624,633,943,0.7,許克信,中國國民黨
南投縣仁愛鄉榮興村,-23,1,24,27,47,0.6,吳國寶,中國國民黨
南投縣仁愛鄉法治村,-311,62,373,489,805,0.6,葉阿良,中國國民黨
南投縣仁愛鄉發祥村,-155,68,223,418,730,0.6,全芊蕙,無
南投縣仁愛鄉精英村,-232,65,297,422,612,0.7,陳松柏,中國國民黨
南投縣仁愛鄉翠華村,-233,25,258,227,494,0.5,高政光,中國國民黨
南投縣仁愛鄉萬豐村,-177,54,231,397,631,0.6,余明星,無
南投縣仁愛鄉親愛村,-343,113,456,688,1104,0.6,潘筱玉,中國國民黨
南投縣仁愛鄉都達村,-225,39,264,323,590,0.5,"阿烏伊．帖木 Awi．Temu",中國國民黨
南投縣信義鄉人和村,-334,93,427,668,1130,0.6,金慕義,無
南投縣信義鄉卡里布安村,-57,50,107,309,506,0.6,田金城,無
南投縣信義鄉同富村,-485,159,644,925,1360,0.7,羅瑞卿,無
南投縣信義鄉地利村,-473,87,560,613,903,0.7,幸國光,無
南投縣信義鄉愛國村,-219,52,271,313,467,0.7,朱祥豪,中國國民黨
南投縣信義鄉新鄉村,-191,36,227,364,561,0.6,田文發Taupas．Tanapima,無
南投縣信義鄉明德村,-487,173,660,978,1398,0.7,吳瑞龍,中國國民黨
南投縣信義鄉望美村,-234,86,320,542,958,0.6,田美玉,無
南投縣信義鄉東埔村,-236,117,353,627,942,0.7,伍金豎Salizan．Islituan,無
南投縣信義鄉潭南村,-246,45,291,361,544,0.7,松照天,無
南投縣信義鄉神木村,-348,64,412,384,598,0.6,忻軍,無
南投縣信義鄉羅娜村,-727,128,855,816,1279,0.6,伍福明,無
南投縣信義鄉自強村,-379,77,456,454,662,0.7,汪家滿,無
南投縣信義鄉豐丘村,-336,62,398,395,615,0.6,全福盛,無
南投縣信義鄉雙龍村,-165,42,207,336,569,0.6,谷鴻志,無
南投縣南投市三和里,-372,421,793,1995,2608,0.8,吳志鵬,無
南投縣南投市三民里,-311,147,458,613,798,0.8,蕭承倉,無
南投縣南投市三興里,-655,824,1479,3800,5187,0.7,賴元周,無
南投縣南投市仁和里,-135,59,194,362,470,0.8,張詠宗,無
南投縣南投市光明里,-405,53,458,544,731,0.7,黃希谷,中國國民黨
南投縣南投市光榮里,-221,89,310,648,872,0.7,鄭深二,中國國民黨
南投縣南投市光華里,-328,64,392,450,615,0.7,王淑美,中國國民黨
南投縣南投市光輝里,-232,72,304,369,462,0.8,沈玉珠,中國國民黨
南投縣南投市內新里,-816,508,1324,2400,3202,0.7,曾丁萬,無
南投縣南投市內興里,-763,864,1627,3888,5079,0.8,劉坤印,無
南投縣南投市千秋里,-523,128,651,693,968,0.7,陳建昌,無
南投縣南投市南投里,-235,83,318,407,528,0.8,陳信嘉,無
南投縣南投市嘉和里,-752,687,1439,3137,4390,0.7,吳孟育,無
南投縣南投市嘉興里,-456,263,719,1415,2033,0.7,張漢其,無
南投縣南投市崇文里,-177,118,295,640,869,0.7,簡汝浜,無
南投縣南投市平和里,-973,930,1903,4251,6015,0.7,林招伯,無
南投縣南投市平山里,-1018,888,1906,3840,5295,0.7,吳繼全,無
南投縣南投市康壽里,-154,224,378,1014,1290,0.8,吳昭俊,無
南投縣南投市彰仁里,-100,51,151,251,335,0.7,張毓真,無
南投縣南投市振興里,-513,267,780,1452,1976,0.7,曾金榜,無
南投縣南投市新興里,-270,874,1144,3472,4980,0.7,石書諭,無
南投縣南投市東山里,-157,46,203,249,351,0.7,曾文聰,無
南投縣南投市永興里,-188,100,288,556,748,0.7,施美莉,無
南投縣南投市永豐里,-452,422,874,1984,2731,0.7,王淑綿,無
南投縣南投市漳和里,-850,1177,2027,5097,6878,0.7,張武釙,無
南投縣南投市漳興里,-519,410,929,1888,2517,0.8,謝慶同,無
南投縣南投市營北里,-1631,910,2541,4557,5737,0.8,戰姵鈴,無
南投縣南投市營南里,-480,435,915,1819,2368,0.8,蔡育民,中國國民黨
南投縣南投市福山里,-351,302,653,1293,1809,0.7,楊勝鴻,無
南投縣南投市福興里,-646,466,1112,2147,2991,0.7,范文蘭,無
南投縣南投市軍功里,-659,698,1357,2964,4128,0.7,吳安妮,無
南投縣南投市鳳山里,-183,112,295,642,986,0.7,許佳明,無
南投縣南投市鳳鳴里,-186,56,242,363,554,0.7,余文廣,無
南投縣南投市龍泉里,-199,125,324,641,860,0.7,許文爵,無
南投縣名間鄉三崙村,-615,199,814,1080,1480,0.7,楊紋練,無
南投縣名間鄉中山村,-629,300,929,1470,2113,0.7,周文華,無
南投縣名間鄉中正村,-814,476,1290,2312,3266,0.7,李溪成,無
南投縣名間鄉仁和村,-403,89,492,576,825,0.7,江宇,無
南投縣名間鄉南雅村,-395,172,567,747,978,0.8,何永生,無
南投縣名間鄉埔中村,-392,95,487,599,790,0.8,陳建州,無
南投縣名間鄉大坑村,-327,75,402,460,680,0.7,陳振科,無
南投縣名間鄉大庄村,-327,235,562,1250,1733,0.7,楊碧雲,無
南投縣名間鄉崁腳村,-400,110,510,609,819,0.7,謝舜日,無
南投縣名間鄉廍下村,-281,119,400,606,887,0.7,陳煥彩,無
南投縣名間鄉新光村,-136,256,392,1176,1637,0.7,陳建次,無
南投縣名間鄉新厝村,-323,93,416,499,691,0.7,陳勇祥,無
南投縣名間鄉新民村,-281,108,389,663,910,0.7,陳峯江,無
南投縣名間鄉新街村,-800,638,1438,2965,4072,0.7,謝明潭,無
南投縣名間鄉東湖村,-649,208,857,1071,1534,0.7,吳元仁,無
南投縣名間鄉松山村,-532,199,731,1060,1415,0.7,陳秀,無
南投縣名間鄉松柏村,-216,192,408,803,1104,0.7,謝文軒,無
南投縣名間鄉濁水村,-599,182,781,1066,1485,0.7,吳欽緯,無
南投縣名間鄉炭寮村,-470,110,580,646,913,0.7,蔡文益,無
南投縣名間鄉田仔村,-132,162,294,861,1197,0.7,陳正昇,無
南投縣名間鄉竹圍村,-421,105,526,653,867,0.8,黃啓樑,無
南投縣名間鄉萬丹村,-291,119,410,649,895,0.7,陳志明,無
南投縣名間鄉赤水村,-544,103,647,784,1107,0.7,陳松明,無
南投縣國姓鄉乾溝村,-307,79,386,484,726,0.7,田基堯,無
南投縣國姓鄉北山村,-382,144,526,917,1379,0.7,劉煥鋒,無
南投縣國姓鄉北港村,-521,186,707,1156,1749,0.7,林慶楨,無
南投縣國姓鄉南港村,-739,133,872,948,1467,0.6,洪永鎮,無
南投縣國姓鄉國姓村,-513,196,709,1071,1568,0.7,彭百慶,無
南投縣國姓鄉大旗村,-206,53,259,401,620,0.6,陳武藏,無
南投縣國姓鄉大石村,-323,77,400,439,650,0.7,楊永瑞,無
南投縣國姓鄉柑林村,-341,139,480,724,1065,0.7,江耀宗,無
南投縣國姓鄉石門村,-469,186,655,1101,1641,0.7,蔡誌成,無
南投縣國姓鄉福龜村,-204,194,398,1170,1675,0.7,曾義坤,無
南投縣國姓鄉長流村,-518,130,648,833,1280,0.7,羅廣霖,無
南投縣國姓鄉長福村,-123,69,192,448,679,0.7,紀典文,無
南投縣國姓鄉長豐村,-272,74,346,450,715,0.6,廖秀文,無
南投縣埔里鎮一新里,-386,79,465,726,938,0.8,林宥岑,無
南投縣埔里鎮北安里,-401,396,797,2157,3005,0.7,葉俊宏,無
南投縣埔里鎮北梅里,-739,454,1193,2149,3101,0.7,潘棋榮,無
南投縣埔里鎮北門里,-904,316,1220,1557,2390,0.7,王金貞,無
南投縣埔里鎮南村里,-244,187,431,887,1307,0.7,潘錦上,無
南投縣埔里鎮南門里,-235,100,335,556,756,0.7,陳昭維,無
南投縣埔里鎮史港里,-79,68,147,385,534,0.7,鍾宗遠,無
南投縣埔里鎮合成里,-406,215,621,1068,1541,0.7,陳信順,無
南投縣埔里鎮同聲里,-882,311,1193,1486,2094,0.7,周文棋,中國國民黨
南投縣埔里鎮向善里,-218,80,298,450,638,0.7,賴志成,中國國民黨
南投縣埔里鎮大城里,-1880,843,2723,3992,5637,0.7,黃鈴蘭,無
南投縣埔里鎮大湳里,-213,293,506,1248,1711,0.7,阮聰智,無
南投縣埔里鎮廣成里,-594,78,672,716,1075,0.7,張國豐,無
南投縣埔里鎮愛蘭里,-522,200,722,935,1355,0.7,陳文富,無
南投縣埔里鎮成功里,-124,25,149,176,272,0.6,彭惠珍,無
南投縣埔里鎮房里里,-304,148,452,892,1281,0.7,林瓊護,無
南投縣埔里鎮東門里,-562,322,884,1732,2487,0.7,江茂圳,無
南投縣埔里鎮杷城里,-450,361,811,1766,2499,0.7,王文䇥,無
南投縣埔里鎮枇杷里,-1571,1092,2663,4936,7228,0.7,陳炫魁,無
南投縣埔里鎮桃米里,-267,104,371,655,967,0.7,曾秀桃,無
南投縣埔里鎮水頭里,-754,491,1245,2485,3723,0.7,廖正裕,無
南投縣埔里鎮泰安里,-762,270,1032,1458,1979,0.7,宋梓賢,無
南投縣埔里鎮清新里,-697,497,1194,2455,3510,0.7,童翎宛,無
南投縣埔里鎮溪南里,-508,141,649,763,1051,0.7,林志良,無
南投縣埔里鎮牛眠里,-1459,355,1814,1940,2767,0.7,潘俊銘,無
南投縣埔里鎮珠格里,-250,145,395,729,1071,0.7,游麗瓊,無
南投縣埔里鎮福興里,-302,93,395,654,932,0.7,黃冠豪,無
南投縣埔里鎮籃城里,-250,130,380,676,912,0.7,蔡榮權,無
南投縣埔里鎮薰化里,-348,135,483,733,976,0.8,黃沛盟,無
南投縣埔里鎮蜈蚣里,-1087,276,1363,1542,2419,0.6,黃美玉,無
南投縣埔里鎮西門里,-682,383,1065,1982,2815,0.7,王美慧,無
南投縣埔里鎮鐵山里,-338,220,558,1155,1644,0.7,林秀惠,無
南投縣埔里鎮麒麟里,-429,111,540,620,973,0.6,黃戊寅,無
南投縣水里鄉上安村,-342,108,450,692,1027,0.7,陳敬家,無
南投縣水里鄉中央村,-166,59,225,372,559,0.7,林錦龍,無
南投縣水里鄉北埔村,-264,122,386,662,984,0.7,賴粟,無
南投縣水里鄉南光村,-421,204,625,1079,1513,0.7,賴建中,無
南投縣水里鄉城中村,-264,106,370,573,823,0.7,賴龍德,無
南投縣水里鄉新城村,-761,162,923,910,1383,0.7,陳景舟,無
南投縣水里鄉新山村,-84,22,106,119,185,0.6,黃郁婷,無
南投縣水里鄉新興村,-127,76,203,381,597,0.6,邱明光,無
南投縣水里鄉民和村,-303,74,377,487,788,0.6,鍾正平,無
南投縣水里鄉水里村,-333,91,424,447,671,0.7,王豐義,無
南投縣水里鄉永興村,-103,20,123,197,286,0.7,許傳福,無
南投縣水里鄉永豐村,-616,153,769,897,1266,0.7,陳韋帆,無
南投縣水里鄉玉峰村,-237,65,302,534,795,0.7,簡秀媛,無
南投縣水里鄉興隆村,-123,17,140,148,259,0.6,甘慶純,無
南投縣水里鄉車埕村,-118,47,165,276,411,0.7,林錫輝,無
南投縣水里鄉農富村,-235,43,278,296,399,0.7,陳昭喜,無
南投縣水里鄉郡坑村,-108,24,132,210,312,0.7,胡弘振,中國國民黨
南投縣水里鄉鉅工村,-282,101,383,597,855,0.7,施惟平,無
南投縣水里鄉頂崁村,-622,131,753,758,1124,0.7,賴清元,無
南投縣竹山鎮下坪里,-450,158,608,844,1155,0.7,余志嘉,無
南投縣竹山鎮中和里,-229,97,326,622,857,0.7,林盈材,無
南投縣竹山鎮中央里,-226,118,344,750,1051,0.7,莊錦川,無
南投縣竹山鎮中山里,-640,574,1214,3215,4483,0.7,蔡宗政,無
南投縣竹山鎮中崎里,-551,173,724,950,1376,0.7,陳福霖,無
南投縣竹山鎮中正里,-176,58,234,417,570,0.7,蘇柏源,無
南投縣竹山鎮坪頂里,-147,41,188,312,437,0.7,陳豊俊,無
南投縣竹山鎮大鞍里,-134,36,170,258,380,0.7,范梓鍊,無
南投縣竹山鎮富州里,-227,71,298,416,565,0.7,楊麗娜,無
南投縣竹山鎮山崇里,-233,232,465,1233,1739,0.7,吳兆修,無
南投縣竹山鎮延和里,-1707,675,2382,3279,4662,0.7,林韓聖,無
南投縣竹山鎮延山里,-347,71,418,549,780,0.7,陳碧棋,無
南投縣竹山鎮延平里,-977,361,1338,1874,2705,0.7,林鴻義,無
南投縣竹山鎮延正里,-699,248,947,1132,1633,0.7,曾庻坪,無
南投縣竹山鎮延祥里,-678,501,1179,2525,3457,0.7,邱雅麟,無
南投縣竹山鎮德興里,-423,101,524,637,851,0.7,陳雅紅,無
南投縣竹山鎮桂林里,-1294,448,1742,2517,3508,0.7,林金賓,無
南投縣竹山鎮桶頭里,-233,67,300,507,814,0.6,黃培基,無
南投縣竹山鎮瑞竹里,-202,45,247,347,544,0.6,林先峯,無
南投縣竹山鎮田子里,-166,62,228,366,534,0.7,吳萬山,無
南投縣竹山鎮硘磘里,-779,272,1051,1291,1741,0.7,廖崇伯,無
南投縣竹山鎮社寮里,-623,188,811,908,1260,0.7,許炳村,中國國民黨
南投縣竹山鎮福興里,-236,79,315,401,571,0.7,林其發,無
南投縣竹山鎮秀林里,-310,69,379,434,617,0.7,林坤裕,無
南投縣竹山鎮竹圍里,-460,272,732,1499,2162,0.7,林志榮,無
南投縣竹山鎮竹山里,-565,240,805,1372,1881,0.7,曾鈺琄,無
南投縣竹山鎮雲林里,-1443,490,1933,2495,3338,0.7,李秋榜,無
南投縣竹山鎮鯉魚里,-209,43,252,457,707,0.6,余如堅,無
南投縣草屯鎮上林里,-1319,533,1852,2384,3095,0.8,蕭世杰,無
南投縣草屯鎮中原里,-426,318,744,1450,1976,0.7,李義遠,無
南投縣草屯鎮中山里,-928,359,1287,1721,2269,0.8,簡妙樺,無
南投縣草屯鎮中正里,-112,101,213,471,621,0.8,李文鑫,無
南投縣草屯鎮加老里,-330,342,672,1623,2151,0.8,洪柏森,無
南投縣草屯鎮北勢里,-311,239,550,1269,1737,0.7,藍俊昇,無
南投縣草屯鎮北投里,-44,518,562,2159,2877,0.8,王枝發,無
南投縣草屯鎮南埔里,-1586,671,2257,3012,4053,0.7,李士吉,無
南投縣草屯鎮和平里,-454,158,612,771,1013,0.8,李永裕,無
南投縣草屯鎮土城里,-563,243,806,1095,1576,0.7,施惟德,無
南投縣草屯鎮坪頂里,-434,143,577,733,976,0.8,李銘樑,無
南投縣草屯鎮富寮里,-818,1230,2048,4947,6878,0.7,簡家俊,無
南投縣草屯鎮山腳里,-2432,1355,3787,5730,7601,0.8,陳松茂,無
南投縣草屯鎮平林里,-323,149,472,773,1037,0.7,謝瑞棋,無
南投縣草屯鎮御史里,-1238,982,2220,4314,5954,0.7,蕭忠憲,無
南投縣草屯鎮復興里,-1178,443,1621,2009,2776,0.7,林健男,無
南投縣草屯鎮敦和里,-491,1108,1599,4614,6250,0.7,洪佩琦,無
南投縣草屯鎮新厝里,-567,535,1102,2415,3168,0.8,簡宏校,無
南投縣草屯鎮新庄里,-637,684,1321,2706,3657,0.7,洪承凱,無
南投縣草屯鎮新豐里,-1680,612,2292,2931,3931,0.7,陳美玲,無
南投縣草屯鎮明正里,-1417,556,1973,2551,3560,0.7,李桂杏,無
南投縣草屯鎮炎峰里,-629,316,945,1468,2006,0.7,洪慶文,無
南投縣草屯鎮玉峰里,-293,299,592,1520,2021,0.8,莊詠鈞,無
南投縣草屯鎮石川里,-311,242,553,1096,1515,0.7,洪日燈,無
南投縣草屯鎮碧峰里,-661,791,1452,3290,4484,0.7,袁玉珍,無
南投縣草屯鎮碧洲里,-601,441,1042,1866,2448,0.8,白淯錡,無
南投縣草屯鎮雙冬里,-714,279,993,1436,2176,0.7,洪朝專,無
南投縣集集鎮八張里,-781,186,967,958,1353,0.7,鄧智全,無
南投縣集集鎮吳厝里,-284,122,406,602,829,0.7,廖文鎬,無
南投縣集集鎮和平里,-302,106,408,615,853,0.7,郭建良,無
南投縣集集鎮富山里,-295,56,351,365,515,0.7,李文賢,無
南投縣集集鎮廣明里,-242,123,365,571,846,0.7,廖貴福,無
南投縣集集鎮林尾里,-142,62,204,372,531,0.7,吳大芳,無
南投縣集集鎮永昌里,-447,131,578,668,904,0.7,陳樹連,無
南投縣集集鎮玉映里,-119,62,181,339,460,0.7,林素玲,無
南投縣集集鎮田寮里,-397,140,537,744,1061,0.7,陳秀雪,無
南投縣集集鎮隘寮里,-65,52,117,292,442,0.7,游世文,無
南投縣集集鎮集集里,-148,146,294,735,1023,0.7,許宗壹,無
南投縣魚池鄉中明村,-405,95,500,613,928,0.7,楊崑欣,無
南投縣魚池鄉五城村,-223,54,277,450,670,0.7,林紹憲,無
南投縣魚池鄉共和村,-292,90,382,520,741,0.7,鄒克忠,無
南投縣魚池鄉大林村,-215,97,312,672,1022,0.7,王增財,無
南投縣魚池鄉大雁村,-159,55,214,383,595,0.6,葉建興,無
南投縣魚池鄉新城村,-515,154,669,1028,1534,0.7,沈華儷,無
南投縣魚池鄉日月村,-214,103,317,583,821,0.7,劉源榮,無
南投縣魚池鄉東光村,-434,126,560,774,1189,0.7,陳峰璋,無
南投縣魚池鄉東池村,-809,181,990,978,1506,0.6,王百祿,中國國民黨
南投縣魚池鄉武登村,-308,52,360,324,536,0.6,黃永斌,無
南投縣魚池鄉水社村,-235,125,360,531,766,0.7,謝明達,無
南投縣魚池鄉頭社村,-369,84,453,533,862,0.6,蕭豊潾,無
南投縣魚池鄉魚池村,-953,207,1160,1241,1856,0.7,盧幸助,中國國民黨
南投縣鹿谷鄉內湖村,-242,118,360,671,939,0.7,陳竹能,無
南投縣鹿谷鄉初鄉村,-225,141,366,905,1333,0.7,林主演,無
南投縣鹿谷鄉和雅村,-342,61,403,419,599,0.7,陳貞復,中國國民黨
南投縣鹿谷鄉廣興村,-865,246,1111,1349,1839,0.7,黃筆顯,無
南投縣鹿谷鄉彰雅村,-436,134,570,919,1217,0.8,余靜芬,無
南投縣鹿谷鄉永隆村,-785,161,946,1075,1482,0.7,何垔墩,無
南投縣鹿谷鄉清水村,-221,54,275,436,623,0.7,黃辛,無
南投縣鹿谷鄉瑞田村,-193,63,256,444,658,0.7,陳銘信,無
南投縣鹿谷鄉秀峰村,-319,58,377,476,710,0.7,曾文香,無
南投縣鹿谷鄉竹林村,-546,121,667,987,1380,0.7,林宏山,無
南投縣鹿谷鄉竹豐村,-401,100,501,606,847,0.7,劉因孟,無
南投縣鹿谷鄉鳳凰村,-693,122,815,888,1250,0.7,劉志成,無
南投縣鹿谷鄉鹿谷村,-634,217,851,1243,1769,0.7,劉御常,無
