村里,2024-2022,2024民眾黨,2022村里長得票,2024投票數,2024選舉人數,2024投票率,里長姓名,里長政黨
澎湖縣七美鄉中和村,-274,41,315,201,593,33.90,李清石,無
澎湖縣七美鄉南港村,-528,65,593,201,593,33.90,夏臨福,無
澎湖縣七美鄉平和村,-137,44,181,201,593,33.90,陳吉財,無
澎湖縣七美鄉東湖村,-113,12,125,78,271,28.78,陳北川,無
澎湖縣七美鄉海豐村,-175,10,185,112,392,28.57,顏鈺穎,無
澎湖縣七美鄉西湖村,-326,6,332,201,593,33.90,呂汶駿,無
澎湖縣望安鄉中社村,-102,16,118,118,352,33.52,陳枻橙,無
澎湖縣望安鄉將軍村,-335,57,392,208,657,31.66,陳郭梅鉛,無
澎湖縣望安鄉東吉村,-86,13,99,80,327,24.46,高宏志,無
澎湖縣望安鄉東坪村,-299,23,322,102,535,19.07,呂東昇,無
澎湖縣望安鄉東安村,-302,23,325,287,695,41.29,許大信,無
澎湖縣望安鄉水垵村,-175,36,211,287,695,41.29,高瑞明,無
澎湖縣望安鄉花嶼村,-155,18,173,95,300,31.67,王玉英,無
澎湖縣望安鄉西坪村,-92,1,93,34,224,15.18,陳森煌,無
澎湖縣望安鄉西安村,-182,23,205,186,457,40.70,許清上,無
澎湖縣湖西鄉中西村,-42,32,74,129,238,54.20,郭宜媚,無
澎湖縣湖西鄉北寮村,-82,37,119,787,1346,58.47,許源章,無
澎湖縣湖西鄉南寮村,-243,56,299,787,1346,58.47,趙浚彬,無
澎湖縣湖西鄉城北村,-157,58,215,289,653,44.26,王明忠,中國國民黨
澎湖縣湖西鄉太武村,-19,21,40,787,1346,58.47,鄭秀娟,無
澎湖縣湖西鄉尖山村,-211,77,288,787,1346,58.47,王家興,無
澎湖縣湖西鄉成功村,-263,149,412,613,1013,60.51,蕭文瑞,無
澎湖縣湖西鄉東石村,-28,23,51,60,129,46.51,黃星良,無
澎湖縣湖西鄉林投村,-228,129,357,787,1346,58.47,莊誌陽,無
澎湖縣湖西鄉沙港村,-199,77,276,487,804,60.57,歐正雄,無
澎湖縣湖西鄉湖東村,-105,47,152,787,1346,58.47,許政忠,無
澎湖縣湖西鄉湖西村,-579,9,588,787,1346,58.47,辛天澤,無
澎湖縣湖西鄉潭邊村,-72,36,108,289,653,44.26,曾國欣,無
澎湖縣湖西鄉白坑村,-67,41,108,787,1346,58.47,許智哲,無
澎湖縣湖西鄉紅羅村,-145,77,222,787,1346,58.47,洪子健,無
澎湖縣湖西鄉菓葉村,-324,62,386,787,1346,58.47,許見興,無
澎湖縣湖西鄉西溪村,-99,137,236,787,1346,58.47,黃文騫,無
澎湖縣湖西鄉許家村,-92,65,157,289,653,44.26,吳淑媜,無
澎湖縣湖西鄉隘門村,-293,109,402,787,1346,58.47,洪聰權,無
澎湖縣湖西鄉青螺村,-57,33,90,787,1346,58.47,李玉立,無
澎湖縣湖西鄉鼎灣村,-245,8,253,289,653,44.26,洪良利,無
澎湖縣湖西鄉龍門村,-214,155,369,787,1346,58.47,洪瑞達,無
澎湖縣白沙鄉中屯村,-72,67,139,323,555,58.20,鄭秋香,無
澎湖縣白沙鄉吉貝村,-174,73,247,541,1031,52.47,謝永乾,無
澎湖縣白沙鄉員貝村,-127,13,140,147,286,51.40,陳天瑞,無
澎湖縣白沙鄉城前村,-47,12,59,61,105,58.10,蕭煒仕,無
澎湖縣白沙鄉大倉村,-64,39,103,541,1031,52.47,鄭尊任,無
澎湖縣白沙鄉小赤村,-58,25,83,86,163,52.76,呂正宗,無
澎湖縣白沙鄉岐頭村,-77,5,82,98,219,44.75,陳志勇,無
澎湖縣白沙鄉後寮村,-286,39,325,350,775,45.16,葉文泉,無
澎湖縣白沙鄉港子村,-97,26,123,152,286,53.15,郭文雅,無
澎湖縣白沙鄉瓦硐村,-113,16,129,146,348,41.95,李江海,無
澎湖縣白沙鄉講美村,-141,56,197,359,672,53.42,楊英三,無
澎湖縣白沙鄉赤崁村,-345,60,405,541,1031,52.47,黃禮聰,無
澎湖縣白沙鄉通梁村,-148,56,204,541,1031,52.47,張健完,無
澎湖縣白沙鄉鎮海村,-51,23,74,75,157,47.77,陳文淵,無
澎湖縣白沙鄉鳥嶼村,-387,57,444,541,1031,52.47,魏錫銘,無
澎湖縣西嶼鄉二崁村,-42,12,54,77,148,52.03,陳昭回,無
澎湖縣西嶼鄉內垵村,-354,82,436,369,696,53.02,莊嬌乃,無
澎湖縣西嶼鄉合界村,-112,40,152,201,399,50.38,楊志業,無
澎湖縣西嶼鄉外垵村,-97,201,298,369,696,53.02,許玉雪,中國國民黨
澎湖縣西嶼鄉大池村,-250,52,302,364,675,53.93,顏光前,無
澎湖縣西嶼鄉小門村,-76,24,100,145,278,52.16,章娥,無
澎湖縣西嶼鄉橫礁村,-70,31,101,140,298,46.98,莊順青,無
澎湖縣西嶼鄉池東村,-134,9,143,369,696,53.02,陳家豐,無
澎湖縣西嶼鄉池西村,-55,26,81,369,696,53.02,洪英俊,無
澎湖縣西嶼鄉竹灣村,-280,61,341,393,815,48.22,許進清,無
澎湖縣西嶼鄉赤馬村,-227,31,258,270,606,44.55,蔡榮利,無
澎湖縣馬公市中央里,-188,55,243,307,522,58.81,項文男,無
澎湖縣馬公市中興里,-293,90,383,428,758,56.46,黃永安,中國國民黨
澎湖縣馬公市五德里,-39,109,148,505,789,64.01,顏錦鸞,無
澎湖縣馬公市井垵里,-95,63,158,505,789,64.01,陳冠霖,無
澎湖縣馬公市光復里,-111,194,305,532,912,58.33,黃敏惠,中國國民黨
澎湖縣馬公市光明里,-392,10,402,741,1262,58.72,陳黃淑媛,無
澎湖縣馬公市光榮里,43,460,417,741,1262,58.72,陳昭任,無
澎湖縣馬公市光華里,-320,19,339,606,1078,56.22,蔡武智,無
澎湖縣馬公市前寮里,-247,165,412,606,1078,56.22,林團圓,無
澎湖縣馬公市啟明里,-139,103,242,532,845,62.96,蔡美珠,無
澎湖縣馬公市安宅里,-98,100,198,606,1078,56.22,張儷盈,無
澎湖縣馬公市山水里,-152,176,328,505,789,64.01,陳安國,無
澎湖縣馬公市嵵裡里,-271,111,382,505,789,64.01,林來續,無
澎湖縣馬公市復興里,-97,81,178,246,446,55.16,紀招治,中國國民黨
澎湖縣馬公市朝陽里,-13,586,599,741,1262,58.72,顏明清,無
澎湖縣馬公市東文里,91,431,340,627,1049,59.77,李美珠,無
澎湖縣馬公市東衛里,-62,259,321,606,1078,56.22,莊福氣,中國國民黨
澎湖縣馬公市案山里,-59,203,262,466,948,49.16,薛益民,無
澎湖縣馬公市桶盤里,-126,49,175,741,1262,58.72,蘇德成,無
澎湖縣馬公市烏崁里,-228,132,360,606,1078,56.22,葉順圓,無
澎湖縣馬公市石泉里,-24,346,370,606,1078,56.22,陳召君,無
澎湖縣馬公市興仁里,-487,181,668,606,1078,56.22,王太平,無
澎湖縣馬公市菜園里,-119,59,178,606,1078,56.22,黃文隆,無
澎湖縣馬公市虎井里,-142,66,208,741,1262,58.72,陳大川,無
澎湖縣馬公市西文里,183,399,216,554,965,57.41,林見芳,無
澎湖縣馬公市西衛里,539,953,414,741,1262,58.72,藍銘洲,無
澎湖縣馬公市重光里,-401,175,576,741,1262,58.72,陳天成,無
澎湖縣馬公市重慶里,-392,99,491,592,895,66.15,葉建祿,無
澎湖縣馬公市鎖港里,-210,268,478,505,789,64.01,蔡成火,無
澎湖縣馬公市鐵線里,-339,17,356,505,789,64.01,陳順志,無
澎湖縣馬公市長安里,-169,82,251,323,514,62.84,楊嘉鵬,無
澎湖縣馬公市陽明里,-290,257,547,741,1262,58.72,黃信義,中國國民黨
澎湖縣馬公市風櫃里,-254,126,380,505,789,64.01,洪有慶,無
