村里,2024-2022,2024民眾黨,2022村里長得票,2024投票數,2024選舉人數,2024投票率,里長姓名,里長政黨
臺中市中區中華里,-563,293,856,1284,1897,0.7,廖榮中,無
臺中市中區光復里,-478,271,749,1289,1842,0.7,張富星,中國國民黨
臺中市中區公園里,-366,172,538,921,1347,0.7,陳裕明,無
臺中市中區大墩里,-589,274,863,1306,1882,0.7,張文華,中國國民黨
臺中市中區大誠里,-826,311,1137,1566,2233,0.7,林志隆,中國國民黨
臺中市中區柳川里,-557,234,791,1152,1856,0.6,蔡翠碧,中國國民黨
臺中市中區綠川里,-355,204,559,1018,1439,0.7,楊文宏,無
臺中市中區繼光里,-298,155,453,979,1408,0.7,吳禎耀,中國國民黨
臺中市北區中正里,-453,167,620,850,1180,0.7,張陳美雲,無
臺中市北區中達里,-488,379,867,1836,2510,0.7,賴文進,無
臺中市北區五常里,-418,230,648,879,1255,0.7,林玉惠,無
臺中市北區健行里,-1834,1097,2931,4769,6377,0.7,何文宏,中國國民黨
臺中市北區光大里,-265,301,566,1398,1989,0.7,朱瑞珠,無
臺中市北區六合里,-540,267,807,1163,1687,0.7,陳豐誠,民主進步黨
臺中市北區大湖里,-504,306,810,1399,2054,0.7,紀國華,無
臺中市北區崇德里,-896,583,1479,2390,3336,0.7,呂成地,無
臺中市北區建德里,-627,467,1094,2334,3112,0.8,鄭凱鶴,無
臺中市北區建成里,-809,1002,1811,3971,5492,0.7,林寬仁,無
臺中市北區建興里,-1607,836,2443,3861,5260,0.7,王平河,無
臺中市北區文莊里,-1128,445,1573,2322,3150,0.7,劉継勇,中國國民黨
臺中市北區新北里,-419,243,662,1127,1588,0.7,陳信志,中國國民黨
臺中市北區新興里,-564,177,741,980,1384,0.7,曹中萍,中國國民黨
臺中市北區明德里,-1546,903,2449,3821,5094,0.8,林麗芬,無
臺中市北區明新里,-796,426,1222,1916,2597,0.7,洪平東,無
臺中市北區梅川里,-841,567,1408,2338,3152,0.7,賴家增,中國國民黨
臺中市北區樂英里,-730,301,1031,1726,2425,0.7,劉玉琦,中國國民黨
臺中市北區淡溝里,-377,848,1225,3655,4938,0.7,何文正,中國國民黨
臺中市北區立人里,-485,640,1125,2589,3681,0.7,黃韻化,無
臺中市北區育德里,-752,543,1295,2558,3508,0.7,黃志銘,無
臺中市北區賴厝里,-660,716,1376,2959,4934,0.6,賴有德,中國國民黨
臺中市北區賴旺里,-725,727,1452,2882,4088,0.7,黃育嘉,無
臺中市北區賴明里,-762,637,1399,2608,3611,0.7,賴茂庭,中國國民黨
臺中市北區賴村里,-669,616,1285,3065,4216,0.7,廖羽婷,無
臺中市北區賴福里,-1292,606,1898,2879,3771,0.8,黃灑晴,中國國民黨
臺中市北區賴興里,-1045,665,1710,2732,3674,0.7,盧冬松,無
臺中市北區邱厝里,-573,343,916,1580,2181,0.7,高敏裕,無
臺中市北區金華里,-559,473,1032,1935,2595,0.7,蘇福安,無
臺中市北區金龍里,-557,684,1241,3114,4368,0.7,楊文欽,無
臺中市北區錦平里,-526,302,828,1273,1827,0.7,游金隆,無
臺中市北區錦村里,-738,499,1237,2309,2988,0.8,吳榮益,中國國民黨
臺中市北區錦洲里,-563,544,1107,2321,3177,0.7,吳昌隆,無
臺中市北區錦祥里,-632,1004,1636,3632,5032,0.7,林美玉,無
臺中市北區長青里,-640,1028,1668,4202,5779,0.7,林裕賜,中國國民黨
臺中市北區頂厝里,-1055,670,1725,2952,4022,0.7,呂理宗,無
臺中市北屯區三光里,-2079,1159,3238,5054,6833,0.7,林瑞芳,中國國民黨
臺中市北屯區三和里,-1963,967,2930,4156,5571,0.7,許勝雄,無
臺中市北屯區仁和里,-2508,1426,3934,6130,9287,0.7,張永漢,無
臺中市北屯區仁愛里,-180,163,343,779,1028,0.8,張耀祖,中國國民黨
臺中市北屯區仁美里,-2417,1929,4346,7149,9431,0.8,朱清華,無
臺中市北屯區北京里,-1078,446,1524,2243,3034,0.7,蘇乙青,無
臺中市北屯區北屯里,-1130,520,1650,2446,3353,0.7,歐真宗,無
臺中市北屯區北興里,-512,515,1027,2367,3191,0.7,廖玉森,無
臺中市北屯區同榮里,-1615,927,2542,4005,5261,0.8,王煌照,中國國民黨
臺中市北屯區后庄里,-2862,1803,4665,7373,9761,0.8,張瓊月,中國國民黨
臺中市北屯區和平里,-1591,2242,3833,8634,11557,0.7,林標權,無
臺中市北屯區四民里,-168,488,656,1685,2201,0.8,江麗慧,中國國民黨
臺中市北屯區大坑里,-785,331,1116,1465,2120,0.7,曾朝瑝,無
臺中市北屯區大德里,-1476,786,2262,3405,4596,0.7,李必勝,中國國民黨
臺中市北屯區平和里,-710,965,1675,3733,5065,0.7,林煜舜,無
臺中市北屯區平安里,-250,847,1097,3794,5141,0.7,吳亞君,無
臺中市北屯區平德里,-1606,1080,2686,4409,6068,0.7,歐志隆,無
臺中市北屯區平心里,-1300,871,2171,3412,4681,0.7,陳文欽,無
臺中市北屯區平昌里,-1177,729,1906,3137,4313,0.7,劉慶雲,中國國民黨
臺中市北屯區平田里,-958,946,1904,4057,5566,0.7,潘玉洪,無
臺中市北屯區平福里,-1114,581,1695,2565,3430,0.7,張振治,無
臺中市北屯區平興里,-797,1234,2031,4857,6652,0.7,黃彰國,無
臺中市北屯區平陽里,-1228,824,2052,3440,4711,0.7,張連進,無
臺中市北屯區平順里,-766,560,1326,2204,3068,0.7,賴錫鏗,無
臺中市北屯區廍子里,-2257,4548,6805,13553,18383,0.7,董銘成,無
臺中市北屯區忠平里,-1388,656,2044,2809,3732,0.8,許秀蓉,中國國民黨
臺中市北屯區新平里,-1322,672,1994,2966,4214,0.7,李良仁,中國國民黨
臺中市北屯區東光里,-1342,741,2083,3261,4509,0.7,賴文章,中國國民黨
臺中市北屯區東山里,-868,251,1119,1502,1995,0.8,邱財源,民主進步黨
臺中市北屯區松勇里,-1646,883,2529,3792,4975,0.8,王嘉君,中國國民黨
臺中市北屯區松和里,-1504,1201,2705,4668,6527,0.7,賴天權,中國國民黨
臺中市北屯區松安里,-746,854,1600,3517,4734,0.7,賴仕翰,無
臺中市北屯區松強里,-1216,1257,2473,4955,6681,0.7,魏清鏘,無
臺中市北屯區松竹里,-1286,1620,2906,6568,8771,0.7,簡禎緯,無
臺中市北屯區松茂里,-1444,889,2333,3766,5108,0.7,何志恆,無
臺中市北屯區民德里,-188,124,312,677,943,0.7,江承鴻,無
臺中市北屯區民政里,-360,137,497,704,994,0.7,黃明華,無
臺中市北屯區水景里,-3666,2512,6178,10138,13473,0.8,何明坤,無
臺中市北屯區水湳里,-1965,1096,3061,4883,6600,0.7,賴進堂,中國國民黨
臺中市北屯區舊社里,215,2992,2777,9405,12479,0.8,謝秉憲,無
臺中市北屯區軍功里,-3403,2342,5745,9404,12351,0.8,黃銘河,無
臺中市北屯區陳平里,-1351,893,2244,3396,4590,0.7,林家峯,中國國民黨
臺中市南區南和里,-1916,1323,3239,5023,7272,0.7,黃寶蓮,無
臺中市南區南門里,-515,572,1087,2612,3436,0.8,何湞惠,無
臺中市南區和平里,24,833,809,3042,4234,0.7,張敏生,無
臺中市南區國光里,-659,554,1213,2725,3665,0.7,廖胤凱,無
臺中市南區城隍里,-647,536,1183,2554,3457,0.7,林炳儀,無
臺中市南區崇倫里,-838,988,1826,4076,5353,0.8,曾素貞,民主進步黨
臺中市南區工學里,-1116,1387,2503,5100,6638,0.8,王文明,無
臺中市南區平和里,-552,517,1069,2521,3397,0.7,柯永宏,無
臺中市南區德義里,-434,444,878,2123,2818,0.8,林志昌,無
臺中市南區新榮里,45,894,849,3474,4672,0.7,蔡明昌,民主進步黨
臺中市南區樹德里,-2373,1753,4126,6500,8386,0.8,余銘記,無
臺中市南區樹義里,-1346,2617,3963,9033,11802,0.8,莊郁雄,無
臺中市南區永和里,-892,849,1741,3345,4564,0.7,李起綸,無
臺中市南區永興里,-616,1569,2185,5936,7853,0.8,陳松鶴,無
臺中市南區江川里,-408,426,834,2027,2662,0.8,楊明俊,無
臺中市南區福平里,-1504,933,2437,3874,5196,0.7,張啓龍,中國國民黨
臺中市南區福興里,-921,571,1492,2811,3717,0.8,陳友龍,無
臺中市南區福順里,-773,1142,1915,4180,5582,0.7,鄭正叡,無
臺中市南區積善里,-654,350,1004,1855,2458,0.8,余惠貞,無
臺中市南區西川里,-1410,763,2173,3086,4122,0.7,葉家宏,無
臺中市南區長春里,-521,240,761,1279,1789,0.7,林姍汝,無
臺中市南區長榮里,-977,371,1348,1773,2297,0.8,林政蒼,無
臺中市南屯區三厝里,-1894,1491,3385,5373,7165,0.7,黃俊銘,民主進步黨
臺中市南屯區三和里,-2165,1671,3836,6513,8587,0.8,張家蓉,無
臺中市南屯區三義里,-1752,1191,2943,4817,6261,0.8,陳惠鈴,無
臺中市南屯區中和里,-1431,683,2114,3101,4122,0.8,蔡德勇,無
臺中市南屯區南屯里,-2512,1502,4014,6229,8332,0.7,林秋潭,中國國民黨
臺中市南屯區同心里,-555,963,1518,3883,5225,0.7,蔡保秀,無
臺中市南屯區向心里,-1273,918,2191,3646,5491,0.7,蕭惠丰,無
臺中市南屯區大同里,-998,930,1928,3710,4840,0.8,游月珠,無
臺中市南屯區大業里,-1955,1143,3098,4933,6572,0.8,賴樹杉,無
臺中市南屯區大興里,-900,746,1646,3285,4321,0.8,許鳳凰,無
臺中市南屯區大誠里,-1059,696,1755,2758,3645,0.8,王宗裕,無
臺中市南屯區寶山里,-487,1077,1564,3869,5216,0.7,廖振源,無
臺中市南屯區惠中里,-1933,1450,3383,5949,8006,0.7,沈呈融,無
臺中市南屯區文山里,-510,2616,3126,8430,11334,0.7,何中信,無
臺中市南屯區文心里,-915,694,1609,2853,3799,0.8,王國在,中國國民黨
臺中市南屯區新生里,-385,662,1047,2432,3232,0.8,盧坤炳,無
臺中市南屯區春安里,-9,718,727,1893,2488,0.8,閻新懃,無
臺中市南屯區春社里,-943,989,1932,4414,6504,0.7,李志洋,無
臺中市南屯區楓樹里,-1481,1052,2533,4699,5996,0.8,陳伯仲,無
臺中市南屯區永定里,-656,948,1604,3920,5150,0.8,賴榮斌,無
臺中市南屯區溝墘里,-1438,956,2394,4112,5296,0.8,郭錦興,中國國民黨
臺中市南屯區田心里,-795,1245,2040,4892,6450,0.8,吳碧珣,無
臺中市南屯區豐樂里,-865,2010,2875,8717,11356,0.8,蔡奇洲,無
臺中市南屯區鎮平里,-523,162,685,966,1245,0.8,廖秀麗,無
臺中市南屯區黎明里,-664,633,1297,3009,3965,0.8,廖福田,中國國民黨
臺中市后里區中和里,-280,414,694,1762,2333,0.8,陳水波,無
臺中市后里區仁里里,-286,149,435,723,982,0.7,鐘基文,無
臺中市后里區公館里,-873,319,1192,1560,2114,0.7,馮詠淮,無
臺中市后里區厚里里,-854,381,1235,1591,2096,0.8,黃金益,無
臺中市后里區后里里,-1103,629,1732,2705,3542,0.8,楊春明,無
臺中市后里區墩北里,-583,605,1188,2591,3474,0.7,羅金浩,無
臺中市后里區墩南里,-1184,584,1768,2513,3322,0.8,陳輝,無
臺中市后里區墩東里,-764,811,1575,3464,4630,0.7,張建湖,無
臺中市后里區墩西里,-696,295,991,1344,1883,0.7,紀廷芳,無
臺中市后里區太平里,-505,360,865,1502,2050,0.7,黃士瑋,無
臺中市后里區廣福里,-745,299,1044,1388,1992,0.7,郭明洲,中國國民黨
臺中市后里區月眉里,-412,326,738,1443,1950,0.7,吳新春,無
臺中市后里區泰安里,-214,239,453,1025,1382,0.7,謝學和,無
臺中市后里區眉山里,-418,618,1036,2396,3221,0.7,潘錦致,無
臺中市后里區義德里,-962,395,1357,1786,2465,0.7,謝榮慶,無
臺中市后里區義里里,-418,498,916,2193,2968,0.7,林東成,無
臺中市后里區聯合里,-393,264,657,1122,1547,0.7,陳查某,無
臺中市后里區舊社里,-478,420,898,1651,2197,0.8,林有盛,無
臺中市和平區中坑里,-103,64,167,344,448,0.8,李明毅,無
臺中市和平區南勢里,-454,235,689,1314,1864,0.7,劉興隆,無
臺中市和平區博愛里,-449,167,616,1071,1567,0.7,范忠文,無
臺中市和平區天輪里,-86,57,143,326,445,0.7,劉興水,無
臺中市和平區平等里,-239,73,312,523,886,0.6,梁韶陽,無
臺中市和平區梨山里,-329,152,481,1016,1928,0.5,賴盛功,無
臺中市和平區自由里,-168,141,309,757,1056,0.7,林永智,無
臺中市和平區達觀里,-300,113,413,796,1109,0.7,吳振福,無
臺中市外埔區三崁里,-326,301,627,1314,1842,0.7,林月草,無
臺中市外埔區中山里,-249,239,488,887,1164,0.8,張素惠,無
臺中市外埔區六分里,-683,414,1097,1604,2144,0.7,劉黃碧霞,無
臺中市外埔區土城里,-491,202,693,1137,1486,0.8,鄭興川,無
臺中市外埔區大同里,-1714,851,2565,3400,4520,0.8,林益年,無
臺中市外埔區大東里,-717,1191,1908,4551,6183,0.7,高芳春,無
臺中市外埔區廍子里,-283,173,456,787,1112,0.7,廖泰祥,無
臺中市外埔區水美里,-487,668,1155,2452,3301,0.7,陳俊樑,無
臺中市外埔區永豐里,-340,203,543,767,1057,0.7,洪俊義,無
臺中市外埔區鐵山里,-537,348,885,1462,2083,0.7,劉圳,無
臺中市外埔區馬鳴里,-544,224,768,953,1314,0.7,顏慶慰,無
臺中市大安區中庄里,-1021,415,1436,1771,2542,0.7,莊明堯,無
臺中市大安區南埔里,-396,142,538,679,987,0.7,林恭,無
臺中市大安區南庄里,-371,160,531,686,960,0.7,陳炳煌,無
臺中市大安區東安里,-537,194,731,899,1173,0.8,黃為德,無
臺中市大安區松雅里,-220,202,422,755,970,0.8,張鐿騰,無
臺中市大安區永安里,-316,284,600,1198,1673,0.7,謝綢,無
臺中市大安區海墘里,-496,239,735,947,1338,0.7,王勝宗,無
臺中市大安區福住里,-236,167,403,730,1038,0.7,吳添福,無
臺中市大安區福興里,-454,187,641,790,1086,0.7,林正岳,無
臺中市大安區西安里,-593,308,901,1212,1668,0.7,紀木淵,無
臺中市大安區頂安里,-240,130,370,618,850,0.7,陳麗涓,無
臺中市大安區龜壳里,-381,237,618,1031,1429,0.7,洪正義,無
臺中市大甲區中山里,-1240,908,2148,3376,4594,0.7,廖嘉佐,中國國民黨
臺中市大甲區南陽里,-336,128,464,570,777,0.7,黃火塗,無
臺中市大甲區大甲里,-371,152,523,697,924,0.8,黃勝裕,無
臺中市大甲區太白里,-255,169,424,844,1155,0.7,游招滿,民主進步黨
臺中市大甲區奉化里,-270,401,671,1484,1961,0.8,白見發,無
臺中市大甲區孔門里,-106,108,214,466,718,0.6,吳柏坤,無
臺中市大甲區孟春里,-1487,630,2117,2713,3822,0.7,黃湘榕,無
臺中市大甲區岷山里,-322,359,681,1468,1990,0.7,林清良,無
臺中市大甲區平安里,-816,317,1133,1425,1919,0.7,周寶惜,無
臺中市大甲區幸福里,-416,389,805,1699,2434,0.7,林晨彬,無
臺中市大甲區庄美里,-666,367,1033,1527,1990,0.8,魏李嫌,無
臺中市大甲區建興里,-486,211,697,1000,1395,0.7,蔡明河,無
臺中市大甲區德化里,-538,329,867,1259,1681,0.7,李柄杉,無
臺中市大甲區文曲里,-374,143,517,714,1040,0.7,林寶彩,無
臺中市大甲區文武里,-1826,981,2807,3834,5106,0.8,葉淑惠,民主進步黨
臺中市大甲區新美里,-1293,568,1861,2398,3194,0.8,王生源,無
臺中市大甲區日南里,-724,971,1695,3837,5380,0.7,邱大豪,無
臺中市大甲區朝陽里,-151,218,369,935,1258,0.7,林立偉,無
臺中市大甲區武曲里,-424,356,780,1313,1728,0.8,蘇月鳳,無
臺中市大甲區武陵里,-307,193,500,832,1124,0.7,方如玉,無
臺中市大甲區江南里,-410,251,661,946,1331,0.7,李文登,無
臺中市大甲區福德里,-452,169,621,755,1056,0.7,莊金波,無
臺中市大甲區義和里,-570,632,1202,2352,3119,0.8,洪黃素貞,無
臺中市大甲區薰風里,-404,131,535,674,862,0.8,王秋芬,無
臺中市大甲區西岐里,-584,290,874,1211,1622,0.7,羅永宗,無
臺中市大甲區銅安里,-256,221,477,924,1311,0.7,林玉生,無
臺中市大甲區頂店里,-227,825,1052,3260,4382,0.7,黃安鎮,無
臺中市大甲區順天里,-319,221,540,1056,1458,0.7,陳威宇,無
臺中市大甲區龍泉里,-513,231,744,1044,1432,0.7,陳廷旺,無
臺中市大肚區中和里,-180,152,332,639,833,0.8,陳怡均,無
臺中市大肚區大東里,-1046,477,1523,2193,2921,0.8,趙政忠,無
臺中市大肚區大肚里,-843,377,1220,1648,2095,0.8,陳銘潭,無
臺中市大肚區山陽里,-313,202,515,955,1271,0.8,黃冠陽,無
臺中市大肚區成功里,-288,164,452,712,911,0.8,陳新座,無
臺中市大肚區新興里,-692,337,1029,1875,2524,0.7,林華龍,無
臺中市大肚區永和里,-330,93,423,586,782,0.7,劉文芳,無
臺中市大肚區永順里,-359,274,633,1273,1650,0.8,陳秋益,無
臺中市大肚區營埔里,-550,253,803,1081,1457,0.7,楊宗吉,無
臺中市大肚區王田里,-399,763,1162,3170,4233,0.7,孫清海,無
臺中市大肚區瑞井里,-871,903,1774,3756,5133,0.7,洪忠祿,無
臺中市大肚區磺溪里,-206,297,503,1276,1657,0.8,趙奕忻,無
臺中市大肚區社腳里,-856,412,1268,1808,2324,0.8,陳榮銀,無
臺中市大肚區福山里,-594,528,1122,2558,3380,0.8,林弘岳,無
臺中市大肚區自強里,-1095,521,1616,2404,3338,0.7,林順安,中國國民黨
臺中市大肚區蔗廍里,-687,851,1538,3576,4969,0.7,童麗香,無
臺中市大肚區頂街里,-2379,1296,3675,5417,7311,0.7,陳武徹,無
臺中市大里區中新里,-690,1079,1769,3852,5312,0.7,廖榮木,無
臺中市大里區仁化里,-690,1548,2238,5916,8108,0.7,陳宗興,無
臺中市大里區仁德里,-1220,1105,2325,4201,5701,0.7,林志忠,無
臺中市大里區健民里,-621,965,1586,3695,5114,0.7,楊進祿,無
臺中市大里區內新里,-278,1576,1854,6036,8207,0.7,林溢源,無
臺中市大里區國光里,-1482,1094,2576,4213,5551,0.8,魏益川,無
臺中市大里區塗城里,-2571,1383,3954,5826,8110,0.7,黃仁耀,中國國民黨
臺中市大里區夏田里,-379,148,527,700,912,0.8,曾盛琪,無
臺中市大里區大元里,-1252,730,1982,2947,3955,0.7,林瑞興,無
臺中市大里區大明里,-519,713,1232,2978,4111,0.7,黃顯堂,民主進步黨
臺中市大里區大里里,-1312,633,1945,2692,3709,0.7,李錫全,無
臺中市大里區新仁里,-1500,1448,2948,5652,7713,0.7,洪家裕,無
臺中市大里區新里里,-1085,1913,2998,7278,10451,0.7,何世琦,無
臺中市大里區日新里,-1330,761,2091,3222,4246,0.8,顏子,無
臺中市大里區東昇里,-344,558,902,2392,3279,0.7,陳進發,無
臺中市大里區東湖里,-2477,1865,4342,7469,10519,0.7,何天祿,無
臺中市大里區東興里,-597,1194,1791,5005,6681,0.7,許榮良,無
臺中市大里區樹王里,-1119,642,1761,2683,3564,0.8,陳俞樺,無
臺中市大里區永隆里,-357,2073,2430,7648,9756,0.8,黃秀玲,無
臺中市大里區瑞城里,-999,2281,3280,8522,11560,0.7,蔡承翰,無
臺中市大里區祥興里,-649,1335,1984,5303,7318,0.7,黃春海,無
臺中市大里區立仁里,-492,984,1476,3750,5270,0.7,孫正宇,無
臺中市大里區立德里,-675,1534,2209,5737,7700,0.7,江慶賢,無
臺中市大里區西榮里,-857,945,1802,3843,5358,0.7,羅文評,無
臺中市大里區西湖里,-927,443,1370,2001,2732,0.7,賴加彬,無
臺中市大里區金城里,-1472,1670,3142,6561,9216,0.7,潘國琦,中國國民黨
臺中市大里區長榮里,-1028,1623,2651,6308,8393,0.8,洪資源,中國國民黨
臺中市大雅區三和里,-1518,1003,2521,3944,5237,0.8,廖顯彬,中國國民黨
臺中市大雅區上楓里,-1682,1274,2956,4714,6290,0.7,鄧兆堂,無
臺中市大雅區上雅里,-263,1237,1500,4323,6022,0.7,陳映辰,無
臺中市大雅區二和里,-1305,1168,2473,4414,5973,0.7,陳明村,無
臺中市大雅區六寶里,-645,1013,1658,4311,5992,0.7,步佔鐘,中國國民黨
臺中市大雅區員林里,-1366,1830,3196,6952,9146,0.8,張本侒,無
臺中市大雅區四德里,-1294,896,2190,3329,4435,0.8,呂啟勳,無
臺中市大雅區大楓里,-509,886,1395,3575,4930,0.7,蔡界地,無
臺中市大雅區大雅里,-1419,722,2141,3203,4233,0.8,李玲珍,無
臺中市大雅區忠義里,-1171,504,1675,2490,3541,0.7,林義木,中國國民黨
臺中市大雅區文雅里,-512,1117,1629,4290,5879,0.7,劉亦銘,無
臺中市大雅區橫山里,-1311,827,2138,3181,4207,0.8,張聖河,無
臺中市大雅區秀山里,-582,574,1156,2489,3289,0.8,蔡錦瑭,無
臺中市大雅區西寶里,-1333,825,2158,3371,4706,0.7,劉孝民,無
臺中市大雅區雅楓里,-741,566,1307,2426,3419,0.7,張東開,無
臺中市太平區中山里,-993,465,1458,2180,3812,0.6,閻泰利,中國國民黨
臺中市太平區中平里,-1302,656,1958,2811,3928,0.7,林碧森,無
臺中市太平區中政里,-970,559,1529,2449,3523,0.7,林宗慶,無
臺中市太平區中興里,-970,531,1501,2250,3069,0.7,林阿爐,無
臺中市太平區光明里,-1066,603,1669,2624,3774,0.7,胥樹文,中國國民黨
臺中市太平區光華里,-1652,810,2462,3723,5194,0.7,黃鐵騫,無
臺中市太平區光隆里,-896,493,1389,2150,2991,0.7,張雅芳,無
臺中市太平區勤益里,-305,340,645,1504,2107,0.7,馮耀祖,中國國民黨
臺中市太平區坪林里,-554,482,1036,2320,3181,0.7,尤文雄,無
臺中市太平區大興里,-315,391,706,1722,2484,0.7,鄭金川,無
臺中市太平區太平里,-727,825,1552,3651,5075,0.7,林龍洲,無
臺中市太平區宜佳里,-1572,1076,2648,4216,5966,0.7,張麗眞,無
臺中市太平區宜昌里,-1082,797,1879,3009,4325,0.7,林進發,無
臺中市太平區宜欣里,-1759,984,2743,4289,6140,0.7,楊登圳,中國國民黨
臺中市太平區平安里,-689,352,1041,1530,2114,0.7,施秀彩,無
臺中市太平區建國里,-774,449,1223,1979,2803,0.7,江德海,中國國民黨
臺中市太平區建興里,-827,384,1211,1848,2803,0.7,胡長志,中國國民黨
臺中市太平區德隆里,-573,828,1401,3323,4730,0.7,吳燕明,無
臺中市太平區成功里,-678,684,1362,2647,3810,0.7,洪大鈞,無
臺中市太平區新光里,-1983,1404,3387,5513,7502,0.7,游癸龍,無
臺中市太平區新吉里,-493,1182,1675,4163,5612,0.7,黃天財,無
臺中市太平區新坪里,-793,1479,2272,5539,7738,0.7,紀進豐,無
臺中市太平區新城里,-335,1176,1511,4054,5905,0.7,胡錩宏,無
臺中市太平區新福里,-1695,1379,3074,5073,6939,0.7,李子濬,無
臺中市太平區新興里,-775,1453,2228,4662,6121,0.8,李建民,無
臺中市太平區新高里,-1766,2048,3814,6614,8838,0.7,江姿樺,無
臺中市太平區東和里,-796,457,1253,1900,2738,0.7,賴來旺,無
臺中市太平區東平里,-611,714,1325,2852,4036,0.7,温錦昌,無
臺中市太平區東汴里,-439,139,578,764,1125,0.7,呂坤龍,無
臺中市太平區永平里,-454,734,1188,2858,4004,0.7,賴義涼,無
臺中市太平區永成里,-689,1273,1962,4925,6773,0.7,陳秋蟬,無
臺中市太平區永隆里,-456,405,861,1788,2436,0.7,張立緯,無
臺中市太平區福隆里,-1079,559,1638,2533,3545,0.7,黃楷能,無
臺中市太平區聖和里,-263,213,476,1057,1503,0.7,劉佳明,無
臺中市太平區興隆里,-593,464,1057,2191,3145,0.7,張閔南,無
臺中市太平區豐年里,-1456,651,2107,3112,4214,0.7,劉盈欣,無
臺中市太平區長億里,-168,1188,1356,4677,6296,0.7,林泳鰡,無
臺中市太平區頭汴里,-473,207,680,1186,1746,0.7,江思涵,無
臺中市太平區黃竹里,-300,72,372,435,600,0.7,林元成,無
臺中市新社區中和里,-283,60,343,406,539,0.8,鄭文章,無
臺中市新社區中正里,-570,218,788,976,1331,0.7,張鳳梅,無
臺中市新社區中興里,-240,55,295,440,584,0.8,李劉秀雲,中國國民黨
臺中市新社區協成里,-1145,374,1519,1987,2791,0.7,王再興,無
臺中市新社區大南里,-482,228,710,1283,1791,0.7,黃逸峯,無
臺中市新社區崑山里,-216,148,364,825,1100,0.8,廖銘洲,無
臺中市新社區復盛里,-712,283,995,1240,1746,0.7,柯廷蓁,無
臺中市新社區慶西里,-309,108,417,602,857,0.7,蔡嘉宜,無
臺中市新社區新社里,-692,507,1199,2375,3145,0.8,黃正光,無
臺中市新社區月湖里,-456,125,581,693,968,0.7,高清源,無
臺中市新社區東興里,-322,161,483,834,1166,0.7,張文明,無
臺中市新社區永源里,-654,413,1067,2181,2853,0.8,蘇東波,無
臺中市新社區福興里,-334,95,429,741,1080,0.7,劉春財,無
臺中市東勢區上城里,-400,139,539,694,922,0.8,張玉雲,無
臺中市東勢區上新里,-229,127,356,700,907,0.8,王綉滿,中國國民黨
臺中市東勢區下城里,-369,93,462,583,810,0.7,劉海湖,無
臺中市東勢區下新里,-327,226,553,1152,1577,0.7,劉發現,無
臺中市東勢區中寧里,-253,117,370,568,793,0.7,廖歆,無
臺中市東勢區中嵙里,-425,251,676,1266,1781,0.7,王鎭樑,無
臺中市東勢區北興里,-250,204,454,949,1377,0.7,李德興,無
臺中市東勢區南平里,-716,245,961,1263,1681,0.8,黃文茂,無
臺中市東勢區埤頭里,-187,98,285,481,636,0.8,林坤詮,無
臺中市東勢區廣興里,-503,177,680,961,1330,0.7,廖紫台,無
臺中市東勢區延平里,-899,280,1179,1491,2044,0.7,吳文龍,無
臺中市東勢區慶東里,-302,229,531,1303,1778,0.7,黃國修,無
臺中市東勢區慶福里,-474,142,616,778,1177,0.7,林金泉,無
臺中市東勢區新盛里,-1179,741,1920,3478,4713,0.7,吳進聰,無
臺中市東勢區明正里,-400,155,555,894,1297,0.7,吳萬明,無
臺中市東勢區東安里,-416,130,546,696,962,0.7,楊嘉裕,無
臺中市東勢區東新里,-474,301,775,1469,1929,0.8,余運來,無
臺中市東勢區泰昌里,-1113,461,1574,2376,3229,0.7,徐鎮富,無
臺中市東勢區泰興里,-298,89,387,498,688,0.7,江國豐,無
臺中市東勢區福隆里,-795,523,1318,2633,3639,0.7,林品巧,無
臺中市東勢區粵寧里,-859,273,1132,1441,1933,0.7,詹德旺,無
臺中市東勢區興隆里,-268,146,414,801,1125,0.7,徐錦全,無
臺中市東勢區茂興里,-674,243,917,1257,1774,0.7,吳仁文,無
臺中市東勢區詒福里,-258,207,465,1132,1544,0.7,郭丞漢,無
臺中市東勢區隆興里,-530,165,695,967,1368,0.7,蘇清泉,無
臺中市東區十甲里,-1465,856,2321,3577,4832,0.7,林昑照,無
臺中市東區合作里,-710,673,1383,2797,3890,0.7,曾建成,中國國民黨
臺中市東區富仁里,-762,572,1334,2804,3915,0.7,施文海,中國國民黨
臺中市東區富台里,-220,234,454,1176,1668,0.7,石國勳,中國國民黨
臺中市東區干城里,-387,370,757,1630,2139,0.8,張碧芝,無
臺中市東區振興里,-611,437,1048,2185,2942,0.7,劉作文,無
臺中市東區新庄里,-913,394,1307,1816,2893,0.6,洪宗毅,無
臺中市東區旱溪里,-460,365,825,1813,2404,0.8,郭松益,無
臺中市東區東信里,-1620,1484,3104,6561,8647,0.8,洪榮吉,無
臺中市東區東勢里,-731,386,1117,1775,2542,0.7,張財良,中國國民黨
臺中市東區東南里,-1035,620,1655,2717,3736,0.7,王瑞發,中國國民黨
臺中市東區東橋里,-814,594,1408,2714,3613,0.8,何冠緯,無
臺中市東區東興里,-419,487,906,2122,2764,0.8,宋茂榮,中國國民黨
臺中市東區東英里,-988,1390,2378,5695,7450,0.8,林德興,無
臺中市東區東門里,-772,1374,2146,5429,7062,0.8,莊錦聰,無
臺中市東區樂成里,-826,387,1213,1716,2378,0.7,曾仁杰,無
臺中市東區泉源里,-758,341,1099,1544,2042,0.8,羅文甫,無
臺中市梧棲區下寮里,-571,322,893,1412,1920,0.7,許福順,無
臺中市梧棲區中和里,-253,59,312,349,471,0.7,林淑貞,無
臺中市梧棲區中正里,-590,628,1218,2637,3727,0.7,林祝女,無
臺中市梧棲區南簡里,-802,1126,1928,4084,5587,0.7,蔡佳君,無
臺中市梧棲區大庄里,-1322,1462,2784,5581,7670,0.7,楊維智,無
臺中市梧棲區大村里,-1833,1086,2919,4117,5630,0.7,陳昆廷,無
臺中市梧棲區安仁里,-282,120,402,518,728,0.7,薛志富,無
臺中市梧棲區文化里,-506,183,689,832,1109,0.8,蔡傳枝,無
臺中市梧棲區永安里,-941,393,1334,1737,2438,0.7,王連松,無
臺中市梧棲區永寧里,-846,345,1191,1622,2225,0.7,李皆得,無
臺中市梧棲區福德里,-667,1019,1686,3706,5145,0.7,紀建豪,無
臺中市梧棲區興農里,-835,476,1311,1809,2503,0.7,陳起益,無
臺中市梧棲區草湳里,-1976,1179,3155,4473,6004,0.7,林槐庭,無
臺中市梧棲區頂寮里,-981,752,1733,2761,3901,0.7,鐘金水,無
臺中市沙鹿區三鹿里,-1590,1655,3245,5610,7570,0.7,顏清通,無
臺中市沙鹿區公明里,-736,778,1514,3125,4276,0.7,蔡水松,無
臺中市沙鹿區六路里,-358,1229,1587,4146,5545,0.7,陳永祥,無
臺中市沙鹿區北勢里,-443,1013,1456,3689,5013,0.7,陳科求,無
臺中市沙鹿區南勢里,-980,732,1712,2585,3330,0.8,王愷,無
臺中市沙鹿區埔子里,-851,1347,2198,4686,6012,0.8,蔡伶青,無
臺中市沙鹿區居仁里,-188,218,406,953,1268,0.8,陳世芳,無
臺中市沙鹿區斗抵里,-464,878,1342,3461,4476,0.8,王宏書,無
臺中市沙鹿區晉江里,-583,325,908,1335,1751,0.8,李瑞珍,無
臺中市沙鹿區沙鹿里,-405,99,504,632,847,0.7,蔡曉婷,無
臺中市沙鹿區洛泉里,-377,289,666,1440,1859,0.8,黃金,無
臺中市沙鹿區清泉里,-803,450,1253,1774,2310,0.8,蔡國欣,無
臺中市沙鹿區犁分里,-351,204,555,819,1082,0.8,陳文宜,無
臺中市沙鹿區福興里,-409,794,1203,3004,3889,0.8,蔣木林,無
臺中市沙鹿區竹林里,-393,1413,1806,5610,7603,0.7,陳吉成,無
臺中市沙鹿區美仁里,-193,69,262,342,454,0.8,陳建良,無
臺中市沙鹿區興仁里,-554,406,960,1824,2363,0.8,劉驊慶,無
臺中市沙鹿區興安里,-562,654,1216,2488,3343,0.7,白來清,無
臺中市沙鹿區西勢里,-855,327,1182,1504,2012,0.7,蔡坤地,無
臺中市沙鹿區鹿寮里,-1244,1310,2554,5424,6988,0.8,王榮正,無
臺中市沙鹿區鹿峰里,-636,1138,1774,4375,5750,0.8,白淞元,無
臺中市清水區下湳里,-622,431,1053,1966,2676,0.7,李王玉蘭,無
臺中市清水區中社里,-310,503,813,2072,2775,0.7,鄭繼光,無
臺中市清水區中興里,-224,65,289,297,372,0.8,蔡興達,無
臺中市清水區北寧里,-305,92,397,506,658,0.8,紀文來,中國國民黨
臺中市清水區南寧里,-673,290,963,1264,1703,0.7,高志勇,無
臺中市清水區南社里,-2380,1971,4351,7564,10146,0.7,崔惠國,無
臺中市清水區吳厝里,-655,222,877,1071,1417,0.8,吳水通,無
臺中市清水區國姓里,-679,262,941,1327,1938,0.7,黃秀英,無
臺中市清水區文昌里,-137,90,227,462,611,0.8,楊介猶,無
臺中市清水區東山里,-483,181,664,820,1160,0.7,王偉權,無
臺中市清水區楊厝里,-488,182,670,773,1082,0.7,曾弘利,無
臺中市清水區槺榔里,-1451,1736,3187,5678,8210,0.7,洪水家,無
臺中市清水區橋頭里,-1878,1332,3210,5477,7275,0.8,林瑶卿,無
臺中市清水區武鹿里,-324,576,900,2562,3514,0.7,陳意和,無
臺中市清水區海濱里,-982,313,1295,1535,2085,0.7,陳山林,無
臺中市清水區海風里,-566,250,816,1012,1352,0.7,黃堉睿,無
臺中市清水區清水里,-357,442,799,1698,2330,0.7,陳安吉,無
臺中市清水區田寮里,-798,372,1170,1607,2362,0.7,許進興,無
臺中市清水區秀水里,-1067,774,1841,3231,4377,0.7,陳月娟,無
臺中市清水區臨江里,-657,206,863,1055,1444,0.7,洪敏哲,無
臺中市清水區菁埔里,-368,353,721,1604,2154,0.7,林子清,無
臺中市清水區裕嘉里,-289,218,507,990,1374,0.7,陳瑞欽,無
臺中市清水區西寧里,-695,227,922,1106,1488,0.7,王慶源,無
臺中市清水區西社里,-680,352,1032,1618,2129,0.8,楊茂雄,無
臺中市清水區靈泉里,-368,139,507,674,871,0.8,顏貽松,無
臺中市清水區頂湳里,-543,260,803,1238,1691,0.7,王景收,無
臺中市清水區高北里,-510,151,661,718,1110,0.6,白銀堂,無
臺中市清水區高南里,-555,179,734,838,1237,0.7,楊忠銘,無
臺中市清水區高東里,-345,188,533,839,1173,0.7,蔡榮聰,無
臺中市清水區高美里,-352,179,531,902,1263,0.7,洪瑞晟,無
臺中市清水區高西里,-582,161,743,854,1230,0.7,洪曜南,無
臺中市清水區鰲峰里,-288,141,429,769,1032,0.7,蔡裕生,無
臺中市潭子區嘉仁里,-1387,683,2070,2941,3932,0.7,林瑞文,無
臺中市潭子區大富里,-945,540,1485,2206,2881,0.8,林啓彬,無
臺中市潭子區大豐里,-671,1198,1869,4526,5993,0.8,廖張玉梅,無
臺中市潭子區家福里,-26,950,976,3505,4586,0.8,賴美芳,中國國民黨
臺中市潭子區家興里,-744,1314,2058,5048,6761,0.7,莊世雄,無
臺中市潭子區新田里,-556,222,778,1105,1489,0.7,吳政潭,無
臺中市潭子區東寶里,-1677,2127,3804,8763,11805,0.7,林銘泉,無
臺中市潭子區栗林里,-823,859,1682,3654,4824,0.8,簡順雄,無
臺中市潭子區潭北里,-742,427,1169,1831,2430,0.8,林俊堂,無
臺中市潭子區潭秀里,-198,219,417,932,1207,0.8,陳健峯,無
臺中市潭子區潭陽里,-1196,1897,3093,7758,10572,0.7,楊仲傑,無
臺中市潭子區甘蔗里,-2830,1842,4672,6909,9288,0.7,黃正堯,中國國民黨
臺中市潭子區福仁里,-2134,1898,4032,7660,10481,0.7,游豐瑋,無
臺中市潭子區聚興里,-617,623,1240,2833,4231,0.7,黃沛綺,無
臺中市潭子區頭家東里,-702,747,1449,3150,4239,0.7,劉進福,中國國民黨
臺中市潭子區頭家里,-1538,1008,2546,3963,5267,0.8,黃聖明,中國國民黨
臺中市烏日區三和里,-1185,1711,2896,5744,7847,0.7,楊添和,無
臺中市烏日區九德里,-1519,2161,3680,9265,12310,0.8,陳美香,無
臺中市烏日區五光里,-373,289,662,1272,1660,0.8,林榮源,無
臺中市烏日區仁德里,-1264,1331,2595,5671,7442,0.8,洪炳煌,中國國民黨
臺中市烏日區光明里,-673,351,1024,1559,2041,0.8,賴信忠,無
臺中市烏日區前竹里,-685,251,936,1185,1523,0.8,林東潭,無
臺中市烏日區北里里,-565,242,807,1229,1588,0.8,魏周森,無
臺中市烏日區南里里,-520,246,766,1019,1313,0.8,蔡敏陽,無
臺中市烏日區學田里,-235,440,675,1900,2562,0.7,孫禾昀,無
臺中市烏日區東園里,-351,426,777,1720,2226,0.8,張有城,無
臺中市烏日區榮泉里,-1466,1446,2912,4840,6348,0.8,何聰智,無
臺中市烏日區湖日里,-470,488,958,1980,2728,0.7,楊來成,無
臺中市烏日區溪埧里,-678,729,1407,3358,4323,0.8,陳登正,無
臺中市烏日區溪尾里,-206,141,347,598,798,0.7,顏寶玉,無
臺中市烏日區烏日里,-645,1625,2270,6568,8494,0.8,陳新安,無
臺中市烏日區螺潭里,-650,366,1016,1678,2106,0.8,林國貞,無
臺中市石岡區九房里,-452,181,633,878,1178,0.7,張鴻斌,民主進步黨
臺中市石岡區和盛里,-491,169,660,872,1181,0.7,何賴財桂,無
臺中市石岡區土牛里,-247,130,377,696,980,0.7,管德財,無
臺中市石岡區德興里,-302,180,482,957,1334,0.7,劉紀雄,無
臺中市石岡區梅子里,-542,250,792,1294,1750,0.7,郭光勇,無
臺中市石岡區石岡里,-402,181,583,853,1143,0.7,陸永晟,無
臺中市石岡區萬安里,-245,249,494,1158,1488,0.8,林子晏,無
臺中市石岡區萬興里,-330,219,549,1073,1388,0.8,羅益洲,無
臺中市石岡區金星里,-310,136,446,855,1174,0.7,李淑惠,無
臺中市石岡區龍興里,-309,75,384,442,604,0.7,黃清標,無
臺中市神岡區三角里,-1022,443,1465,1963,2556,0.8,江炳煌,無
臺中市神岡區北庄里,-383,446,829,1962,2549,0.8,王秋生,無
臺中市神岡區圳前里,-802,350,1152,1596,2191,0.7,陳木生,中國國民黨
臺中市神岡區圳堵里,-470,357,827,1525,2038,0.7,鄭秀燕,無
臺中市神岡區大社里,-923,839,1762,3172,4369,0.7,高元平,無
臺中市神岡區山皮里,-431,156,587,754,981,0.8,陳勝泧,民主進步黨
臺中市神岡區岸裡里,-941,438,1379,2100,2775,0.8,謝繼潭,無
臺中市神岡區庄前里,-516,429,945,1719,2214,0.8,張鎮正,無
臺中市神岡區庄後里,-428,350,778,1661,2162,0.8,林吳春蘭,無
臺中市神岡區新庄里,-695,671,1366,2868,4007,0.7,張育豪,無
臺中市神岡區溪洲里,-1048,456,1504,2077,2711,0.8,王明洲,無
臺中市神岡區社南里,-679,1005,1684,3855,5097,0.8,楊春福,民主進步黨
臺中市神岡區社口里,-557,1415,1972,5548,7475,0.7,陳金地,無
臺中市神岡區神岡里,-1044,529,1573,2241,3073,0.7,王百瀛,無
臺中市神岡區神洲里,-619,416,1035,1858,2436,0.8,陳大燿,無
臺中市神岡區豐洲里,-1928,1164,3092,5155,6949,0.7,王文松,無
臺中市西區三民里,-531,256,787,1247,2314,0.5,廖吳芬芳,無
臺中市西區中興里,-932,533,1465,2623,3462,0.8,湯鈞任,無
臺中市西區公平里,-1457,818,2275,3616,4940,0.7,魏素眞,中國國民黨
臺中市西區公德里,-699,743,1442,3147,4183,0.8,楊博文,中國國民黨
臺中市西區公正里,-1091,1147,2238,4733,6212,0.8,林哲雄,中國國民黨
臺中市西區公民里,-396,740,1136,3538,4724,0.7,林鈞陶,無
臺中市西區公益里,-997,439,1436,1984,2640,0.8,劉興峰,無
臺中市西區公舘里,-815,901,1716,4053,5464,0.7,謝錫宏,無
臺中市西區利民里,-413,204,617,956,1282,0.7,陳敏祥,中國國民黨
臺中市西區双龍里,-369,401,770,1925,2639,0.7,林坤泉,中國國民黨
臺中市西區吉龍里,-625,1071,1696,4695,6287,0.7,李國禎,無
臺中市西區和龍里,-520,331,851,1566,2199,0.7,孟慶華,無
臺中市西區土庫里,-1114,857,1971,4074,5451,0.7,粟藍倩,無
臺中市西區大忠里,-1308,803,2111,3344,4237,0.8,張智權,無
臺中市西區安龍里,-1006,430,1436,2022,2707,0.7,賴梁松,無
臺中市西區平和里,-248,297,545,1268,1771,0.7,張洪惠雪,中國國民黨
臺中市西區廣民里,-473,195,668,960,1329,0.7,林水順,無
臺中市西區後龍里,-495,515,1010,2416,3277,0.7,郭耀泉,無
臺中市西區忠明里,-1661,877,2538,4078,5606,0.7,賴瑞滄,無
臺中市西區忠誠里,-990,883,1873,4006,5427,0.7,趙瑞豐,無
臺中市西區昇平里,-1756,930,2686,4051,5472,0.7,蕭行凱,無
臺中市西區東昇里,-740,347,1087,1640,2127,0.8,徐耀鍾,無
臺中市西區民生里,-516,272,788,1252,1677,0.7,黃文濱,中國國民黨
臺中市西區民龍里,-908,626,1534,2548,3473,0.7,吳國楨,中國國民黨
臺中市西區藍興里,-685,700,1385,3057,3883,0.8,黃富榮,無
臺中市西屯區上安里,-673,1016,1689,3860,5206,0.7,賴耀熙,無
臺中市西屯區上德里,-1165,689,1854,3008,4074,0.7,洪頊晿,無
臺中市西屯區上石里,-21,1055,1076,3676,5013,0.7,廖年新,無
臺中市西屯區何仁里,-766,1125,1891,4469,5989,0.7,蔡翔宇,無
臺中市西屯區何南里,-1045,731,1776,3053,4028,0.8,曹豐洋,無
臺中市西屯區何厝里,-869,527,1396,2231,3100,0.7,何劉美玲,無
臺中市西屯區何安里,-1327,991,2318,4147,5725,0.7,何唐文鈴,無
臺中市西屯區何德里,-367,676,1043,2722,3608,0.8,陳振甫,無
臺中市西屯區何成里,-1919,1104,3023,4637,6255,0.7,田貴玉,無
臺中市西屯區何明里,-1232,560,1792,2567,3394,0.8,趙淑妙,無
臺中市西屯區何源里,-1825,1178,3003,4798,6477,0.7,彭琴安,中國國民黨
臺中市西屯區何福里,-590,742,1332,3195,4216,0.8,何淑玲,民主進步黨
臺中市西屯區協和里,-957,849,1806,3342,4556,0.7,陳靖益,無
臺中市西屯區大河里,-678,628,1306,2922,3771,0.8,陳資源,無
臺中市西屯區大石里,-518,327,845,1612,2124,0.8,吳忠華,中國國民黨
臺中市西屯區大福里,-1088,517,1605,2224,3222,0.7,高信增,中國國民黨
臺中市西屯區大鵬里,-372,786,1158,3353,4574,0.7,邱清涼,中國國民黨
臺中市西屯區廣福里,-904,332,1236,1681,2191,0.8,吳賢龍,無
臺中市西屯區惠來里,-1456,2573,4029,11086,15385,0.7,廖慶麟,無
臺中市西屯區林厝里,-807,629,1436,2512,3395,0.7,余進卿,中國國民黨
臺中市西屯區永安里,-804,2548,3352,8960,12509,0.7,張阿淑,中國國民黨
臺中市西屯區港尾里,-1417,885,2302,3677,4970,0.7,楊忠義,無
臺中市西屯區潮洋里,-1375,1107,2482,4309,6776,0.6,陳素貞,無
臺中市西屯區福中里,-379,588,967,2334,3163,0.7,廖阿月,中國國民黨
臺中市西屯區福和里,-660,756,1416,3108,4215,0.7,林寅利,無
臺中市西屯區福安里,-306,625,931,2274,2995,0.8,張清和,無
臺中市西屯區福恩里,-466,991,1457,3616,4765,0.8,張保德,無
臺中市西屯區福林里,-1103,1598,2701,5746,7723,0.7,林柏翰,無
臺中市西屯區福瑞里,-656,552,1208,2069,2952,0.7,林添憶,中國國民黨
臺中市西屯區福聯里,-628,602,1230,2222,3307,0.7,馮進通,無
臺中市西屯區福雅里,-1670,1160,2830,4266,5741,0.7,王勝偉,中國國民黨
臺中市西屯區至善里,-1164,793,1957,3223,4335,0.7,鄭文昌,無
臺中市西屯區西墩里,-121,1186,1307,4589,6092,0.8,廖家慧,無
臺中市西屯區西安里,-298,1156,1454,4080,5428,0.8,徐文電,無
臺中市西屯區西平里,-1254,828,2082,3391,4842,0.7,廖建森,中國國民黨
臺中市西屯區逢甲里,-1227,862,2089,3334,4583,0.7,廖婉菁,無
臺中市西屯區逢福里,-1158,916,2074,3885,5203,0.7,張文平,無
臺中市西屯區鵬程里,-423,343,766,1822,2487,0.7,陳文聿,中國國民黨
臺中市西屯區龍潭里,-212,172,384,754,1004,0.8,張清文,無
臺中市豐原區三村里,-982,1140,2122,4634,6081,0.8,許全木,無
臺中市豐原區下街里,-65,146,211,570,744,0.8,林貴榮,無
臺中市豐原區中山里,-234,121,355,609,772,0.8,林榮一,無
臺中市豐原區中興里,-1053,509,1562,2089,2822,0.7,魏丞章,無
臺中市豐原區中陽里,-1218,906,2124,3935,5087,0.8,黃英瑜,無
臺中市豐原區北湳里,-203,566,769,2312,3000,0.8,張靜宜,無
臺中市豐原區北陽里,-1619,2309,3928,9699,12770,0.8,林清水,無
臺中市豐原區南嵩里,-377,552,929,2428,3251,0.7,劉玉玲,無
臺中市豐原區南村里,-1131,988,2119,3924,5225,0.8,謝見忠,無
臺中市豐原區南田里,-589,544,1133,2323,3102,0.7,劉醇權,無
臺中市豐原區南陽里,-2978,1939,4917,7769,10371,0.7,楊國勝,無
臺中市豐原區圳寮里,-264,213,477,936,1186,0.8,陳坤湖,無
臺中市豐原區大湳里,-571,429,1000,1794,2419,0.7,張鳳茹,無
臺中市豐原區富春里,-355,91,446,529,662,0.8,陳麗鳳,無
臺中市豐原區朴子里,-459,560,1019,2422,3196,0.8,張錦順,無
臺中市豐原區東勢里,-577,189,766,1000,1369,0.7,胡慧玲,無
臺中市豐原區東湳里,-873,698,1571,2969,3896,0.8,唐志勇,無
臺中市豐原區東陽里,-564,214,778,1171,1508,0.8,張德勲,無
臺中市豐原區民生里,-183,175,358,791,1069,0.7,吳俊德,無
臺中市豐原區田心里,-1840,1023,2863,4255,6128,0.7,徐倍基,無
臺中市豐原區社皮里,-2183,1778,3961,7127,9626,0.7,涂力旋,中國國民黨
臺中市豐原區翁子里,-1240,585,1825,2403,3204,0.8,連佳振,無
臺中市豐原區翁明里,-270,463,733,1702,2213,0.8,高銘傳,無
臺中市豐原區翁社里,-816,326,1142,1517,1993,0.8,吳安修,無
臺中市豐原區葫蘆里,-116,85,201,428,576,0.7,王彥閔,無
臺中市豐原區西勢里,-474,360,834,1622,2102,0.8,王建清,無
臺中市豐原區西安里,-1018,863,1881,3569,4651,0.8,羅茂榮,無
臺中市豐原區西湳里,-1309,1778,3087,6868,9105,0.8,蔣年峯,無
臺中市豐原區豐原里,-434,349,783,1568,2191,0.7,洪源隆,無
臺中市豐原區豐圳里,-715,593,1308,2496,3220,0.8,鄭文鑫,無
臺中市豐原區豐榮里,-395,162,557,779,1052,0.7,林金玉,無
臺中市豐原區豐田里,-2077,1715,3792,7408,9949,0.7,劉瑞銓,中國國民黨
臺中市豐原區豐西里,-461,274,735,1200,1571,0.8,葉明昌,無
臺中市豐原區鎌村里,-818,758,1576,3427,4493,0.8,林隆源,無
臺中市豐原區陽明里,-249,456,705,1991,2551,0.8,林汶垚,無
臺中市豐原區頂街里,-276,135,411,645,886,0.7,吳令儀,無
臺中市霧峰區丁台里,-460,350,810,1698,2234,0.8,施豐碧,無
臺中市霧峰區中正里,-199,354,553,1510,1921,0.8,林進生,無
臺中市霧峰區五福里,-821,425,1246,1968,2561,0.8,陳岳彬,無
臺中市霧峰區六股里,-946,356,1302,1767,2287,0.8,王原祥,無
臺中市霧峰區北勢里,-862,330,1192,1563,1999,0.8,洪金生,無
臺中市霧峰區北柳里,-561,680,1241,3020,3909,0.8,吳儒親,無
臺中市霧峰區南勢里,-473,191,664,944,1242,0.8,黃清標,無
臺中市霧峰區南柳里,-443,325,768,1406,1852,0.8,楊國忠,無
臺中市霧峰區吉峰里,-1693,1459,3152,6528,9085,0.7,林政逸,無
臺中市霧峰區四德里,-723,457,1180,1794,2443,0.7,紀天富,無
臺中市霧峰區坑口里,-364,420,784,2092,2861,0.7,王中興,無
臺中市霧峰區峰谷里,-215,171,386,805,1087,0.7,黃錦昌,無
臺中市霧峰區本堂里,-962,970,1932,4231,5678,0.7,林錦池,無
臺中市霧峰區本鄉里,-516,370,886,1697,2238,0.8,林揚展,無
臺中市霧峰區桐林里,-132,200,332,925,1179,0.8,林國安,無
臺中市霧峰區甲寅里,-606,765,1371,3431,4636,0.7,陳麒翔,無
臺中市霧峰區舊正里,-734,312,1046,1496,1996,0.7,張國財,無
臺中市霧峰區萊園里,-237,159,396,761,988,0.8,唐青山,無
臺中市霧峰區萬豐里,-842,342,1184,1805,2501,0.7,林麗真,無
臺中市霧峰區錦榮里,-429,195,624,927,1240,0.7,張永昇,無
臺中市龍井區三德里,-167,495,662,2094,2820,0.7,楊易明,無
臺中市龍井區南寮里,-353,238,591,1222,1498,0.8,林志強,無
臺中市龍井區山腳里,-569,1084,1653,4188,5705,0.7,陳春雄,無
臺中市龍井區忠和里,-922,899,1821,3565,4717,0.8,林聰海,無
臺中市龍井區新庄里,-1624,1126,2750,4526,6119,0.7,陳進爵,無
臺中市龍井區新東里,-1352,833,2185,3448,4746,0.7,劉克俊,無
臺中市龍井區東海里,-1128,1568,2696,6287,8523,0.7,林秋蘭,無
臺中市龍井區田中里,-1093,744,1837,2891,3775,0.8,張文慶,無
臺中市龍井區福田里,-294,142,436,712,1009,0.7,歐錦墩,無
臺中市龍井區竹坑里,-858,612,1470,2304,3094,0.7,許麗珠,無
臺中市龍井區麗水里,-658,360,1018,1618,2159,0.7,陳耀墩,無
臺中市龍井區龍崗里,-912,490,1402,2041,2739,0.7,林朝清,無
臺中市龍井區龍東里,-347,531,878,2117,2893,0.7,林金鍊,無
臺中市龍井區龍泉里,-1296,1484,2780,5787,7954,0.7,黃聖龍,無
臺中市龍井區龍津里,-1641,896,2537,3569,4848,0.7,張坤雄,無
臺中市龍井區龍西里,-459,287,746,1330,1751,0.8,黃碧林,無
