村里,2024-2022,2024民眾黨,2022村里長得票,2024投票數,2024選舉人數,2024投票率,里長姓名,里長政黨
臺中市中區中華里,-115,293,408,1284,1897,0.7,廖榮中,無
臺中市中區光復里,-195,271,466,1289,1842,0.7,張富星,中國國民黨
臺中市中區公園里,-366,172,538,921,1347,0.7,陳裕明,無
臺中市中區大墩里,-111,274,385,1306,1882,0.7,張文華,中國國民黨
臺中市中區大誠里,-327,311,638,1566,2233,0.7,林志隆,中國國民黨
臺中市中區柳川里,-125,234,359,1152,1856,0.6,蔡翠碧,中國國民黨
臺中市中區綠川里,-355,204,559,1018,1439,0.7,楊文宏,無
臺中市中區繼光里,-659,155,814,979,1408,0.7,吳禎耀,中國國民黨
臺中市北區中正里,-453,167,620,850,1180,0.7,張陳美雲,無
臺中市北區中達里,-339,379,718,1836,2510,0.7,賴文進,無
臺中市北區五常里,-418,230,648,879,1255,0.7,林玉惠,無
臺中市北區健行里,354,1097,743,4769,6377,0.7,何文宏,中國國民黨
臺中市北區光大里,-242,301,543,1398,1989,0.7,朱瑞珠,無
臺中市北區六合里,-540,267,807,1163,1687,0.7,陳豐誠,民主進步黨
臺中市北區大湖里,-234,306,540,1399,2054,0.7,紀國華,無
臺中市北區崇德里,126,583,457,2390,3336,0.7,呂成地,無
臺中市北區建德里,89,467,378,2334,3112,0.8,鄭凱鶴,無
臺中市北區建成里,195,1002,807,3971,5492,0.7,林寬仁,無
臺中市北區建興里,375,836,461,3861,5260,0.7,王平河,無
臺中市北區文莊里,-300,445,745,2322,3150,0.7,劉継勇,中國國民黨
臺中市北區新北里,-111,243,354,1127,1588,0.7,陳信志,中國國民黨
臺中市北區新興里,-168,177,345,980,1384,0.7,曹中萍,中國國民黨
臺中市北區明德里,341,903,562,3821,5094,0.8,林麗芬,無
臺中市北區明新里,-174,426,600,1916,2597,0.7,洪平東,無
臺中市北區梅川里,-148,567,715,2338,3152,0.7,賴家增,中國國民黨
臺中市北區樂英里,-126,301,427,1726,2425,0.7,劉玉琦,中國國民黨
臺中市北區淡溝里,510,848,338,3655,4938,0.7,何文正,中國國民黨
臺中市北區立人里,278,640,362,2589,3681,0.7,黃韻化,無
臺中市北區育德里,0,543,543,2558,3508,0.7,黃志銘,無
臺中市北區賴厝里,243,716,473,2959,4934,0.6,賴有德,中國國民黨
臺中市北區賴旺里,10,727,717,2882,4088,0.7,黃育嘉,無
臺中市北區賴明里,16,637,621,2608,3611,0.7,賴茂庭,中國國民黨
臺中市北區賴村里,-188,616,804,3065,4216,0.7,廖羽婷,無
臺中市北區賴福里,99,606,507,2879,3771,0.8,黃灑晴,中國國民黨
臺中市北區賴興里,86,665,579,2732,3674,0.7,盧冬松,無
臺中市北區邱厝里,-114,343,457,1580,2181,0.7,高敏裕,無
臺中市北區金華里,-59,473,532,1935,2595,0.7,蘇福安,無
臺中市北區金龍里,-51,684,735,3114,4368,0.7,馬國樑,無
臺中市北區錦平里,-87,302,389,1273,1827,0.7,游金隆,無
臺中市北區錦村里,-79,499,578,2309,2988,0.8,吳榮益,中國國民黨
臺中市北區錦洲里,193,544,351,2321,3177,0.7,吳昌隆,無
臺中市北區錦祥里,349,1004,655,3632,5032,0.7,林美玉,無
臺中市北區長青里,244,1028,784,4202,5779,0.7,林裕賜,中國國民黨
臺中市北區頂厝里,79,670,591,2952,4022,0.7,呂理宗,無
臺中市北屯區三光里,658,1159,501,5054,6833,0.7,林瑞芳,中國國民黨
臺中市北屯區三和里,301,967,666,4156,5571,0.7,許勝雄,無
臺中市北屯區仁和里,782,1426,644,6130,9287,0.7,張永漢,無
臺中市北屯區仁愛里,-277,163,440,779,1028,0.8,張耀祖,中國國民黨
臺中市北屯區仁美里,1250,1929,679,7149,9431,0.8,朱清華,無
臺中市北屯區北京里,-141,446,587,2243,3034,0.7,蘇乙青,無
臺中市北屯區北屯里,-19,520,539,2446,3353,0.7,歐真宗,無
臺中市北屯區北興里,20,515,495,2367,3191,0.7,廖玉森,無
臺中市北屯區同榮里,312,927,615,4005,5261,0.8,王煌照,中國國民黨
臺中市北屯區后庄里,1189,1803,614,7373,9761,0.8,張瓊月,中國國民黨
臺中市北屯區和平里,1811,2242,431,8634,11557,0.7,林標權,無
臺中市北屯區四民里,-456,488,944,1685,2201,0.8,江麗慧,中國國民黨
臺中市北屯區大坑里,-182,331,513,1465,2120,0.7,曾朝瑝,無
臺中市北屯區大德里,204,786,582,3405,4596,0.7,李必勝,中國國民黨
臺中市北屯區平和里,287,965,678,3733,5065,0.7,林煜舜,無
臺中市北屯區平安里,242,847,605,3794,5141,0.7,吳亞君,無
臺中市北屯區平德里,634,1080,446,4409,6068,0.7,歐志隆,無
臺中市北屯區平心里,302,871,569,3412,4681,0.7,陳文欽,無
臺中市北屯區平昌里,281,729,448,3137,4313,0.7,劉慶雲,中國國民黨
臺中市北屯區平田里,367,946,579,4057,5566,0.7,潘玉洪,無
臺中市北屯區平福里,-21,581,602,2565,3430,0.7,張振治,無
臺中市北屯區平興里,826,1234,408,4857,6652,0.7,黃彰國,無
臺中市北屯區平陽里,243,824,581,3440,4711,0.7,張連進,無
臺中市北屯區平順里,86,560,474,2204,3068,0.7,賴錫鏗,無
臺中市北屯區廍子里,3891,4548,657,13553,18383,0.7,董銘成,無
臺中市北屯區忠平里,75,656,581,2809,3732,0.8,許秀蓉,中國國民黨
臺中市北屯區新平里,-20,672,692,2966,4214,0.7,李良仁,中國國民黨
臺中市北屯區東光里,187,741,554,3261,4509,0.7,賴文章,中國國民黨
臺中市北屯區東山里,-228,251,479,1502,1995,0.8,邱財源,民主進步黨
臺中市北屯區松勇里,199,883,684,3792,4975,0.8,王嘉君,中國國民黨
臺中市北屯區松和里,684,1201,517,4668,6527,0.7,賴天權,中國國民黨
臺中市北屯區松安里,447,854,407,3517,4734,0.7,賴仕翰,無
臺中市北屯區松強里,703,1257,554,4955,6681,0.7,魏清鏘,無
臺中市北屯區松竹里,826,1620,794,6568,8771,0.7,簡禎緯,無
臺中市北屯區松茂里,327,889,562,3766,5108,0.7,何志恆,無
臺中市北屯區民德里,-188,124,312,677,943,0.7,江承鴻,無
臺中市北屯區民政里,-360,137,497,704,994,0.7,黃明華,無
臺中市北屯區水景里,2093,2512,419,10138,13473,0.8,何明坤,無
臺中市北屯區水湳里,568,1096,528,4883,6600,0.7,賴進堂,中國國民黨
臺中市北屯區舊社里,2593,2992,399,9405,12479,0.8,謝秉憲,無
臺中市北屯區軍功里,1739,2342,603,9404,12351,0.8,黃銘河,無
臺中市北屯區陳平里,390,893,503,3396,4590,0.7,林家峯,中國國民黨
臺中市南區南和里,711,1323,612,5023,7272,0.7,黃寶蓮,無
臺中市南區南門里,185,572,387,2612,3436,0.8,何湞惠,無
臺中市南區和平里,553,833,280,3042,4234,0.7,張敏生,無
臺中市南區國光里,-189,554,743,2725,3665,0.7,廖胤凱,無
臺中市南區城隍里,156,536,380,2554,3457,0.7,林炳儀,無
臺中市南區崇倫里,596,988,392,4076,5353,0.8,曾素貞,民主進步黨
臺中市南區工學里,853,1387,534,5100,6638,0.8,王文明,無
臺中市南區平和里,-140,517,657,2521,3397,0.7,柯永宏,無
臺中市南區德義里,-6,444,450,2123,2818,0.8,林志昌,無
臺中市南區新榮里,516,894,378,3474,4672,0.7,李銷容,中國國民黨
臺中市南區樹德里,1124,1753,629,6500,8386,0.8,余銘記,無
臺中市南區樹義里,1804,2617,813,9033,11802,0.8,莊郁雄,無
臺中市南區永和里,242,849,607,3345,4564,0.7,李起綸,無
臺中市南區永興里,1111,1569,458,5936,7853,0.8,陳松鶴,無
臺中市南區江川里,-411,426,837,2027,2662,0.8,楊明俊,無
臺中市南區福平里,302,933,631,3874,5196,0.7,張啓龍,中國國民黨
臺中市南區福興里,-101,571,672,2811,3717,0.8,陳友龍,無
臺中市南區福順里,358,1142,784,4180,5582,0.7,鄭正叡,無
臺中市南區積善里,-171,350,521,1855,2458,0.8,余惠貞,無
臺中市南區西川里,30,763,733,3086,4122,0.7,葉家宏,無
臺中市南區長春里,-282,240,522,1279,1789,0.7,林姍汝,無
臺中市南區長榮里,-324,371,695,1773,2297,0.8,林政蒼,無
臺中市南屯區三厝里,832,1491,659,5373,7165,0.7,黃俊銘,民主進步黨
臺中市南屯區三和里,1081,1671,590,6513,8587,0.8,張家蓉,無
臺中市南屯區三義里,636,1191,555,4817,6261,0.8,陳惠鈴,無
臺中市南屯區中和里,-57,683,740,3101,4122,0.8,蔡德勇,無
臺中市南屯區南屯里,969,1502,533,6229,8332,0.7,林秋潭,中國國民黨
臺中市南屯區同心里,368,963,595,3883,5225,0.7,蔡保秀,無
臺中市南屯區向心里,245,918,673,3646,5491,0.7,蕭惠丰,無
臺中市南屯區大同里,448,930,482,3710,4840,0.8,游月珠,無
臺中市南屯區大業里,452,1143,691,4933,6572,0.8,賴樹杉,無
臺中市南屯區大興里,227,746,519,3285,4321,0.8,許鳳凰,無
臺中市南屯區大誠里,140,696,556,2758,3645,0.8,王宗裕,無
臺中市南屯區寶山里,325,1077,752,3869,5216,0.7,廖振源,無
臺中市南屯區惠中里,746,1450,704,5949,8006,0.7,沈呈融,無
臺中市南屯區文山里,1714,2616,902,8430,11334,0.7,何中信,無
臺中市南屯區文心里,227,694,467,2853,3799,0.8,王國在,中國國民黨
臺中市南屯區新生里,230,662,432,2432,3232,0.8,盧坤炳,無
臺中市南屯區春安里,-159,718,877,1893,2488,0.8,閻新懃,無
臺中市南屯區春社里,370,989,619,4414,6504,0.7,李志洋,無
臺中市南屯區楓樹里,186,1052,866,4699,5996,0.8,陳伯仲,無
臺中市南屯區永定里,484,948,464,3920,5150,0.8,賴榮斌,無
臺中市南屯區溝墘里,314,956,642,4112,5296,0.8,郭錦興,中國國民黨
臺中市南屯區田心里,720,1245,525,4892,6450,0.8,吳碧珣,無
臺中市南屯區豐樂里,1630,2010,380,8717,11356,0.8,陳建州,無
臺中市南屯區鎮平里,-226,162,388,966,1245,0.8,廖秀麗,無
臺中市南屯區黎明里,288,633,345,3009,3965,0.8,馬蓮菁,無
臺中市后里區中和里,-110,414,524,1762,2333,0.8,陳水波,無
臺中市后里區仁里里,-286,149,435,723,982,0.7,鐘基文,無
臺中市后里區公館里,-265,319,584,1560,2114,0.7,馮詠淮,無
臺中市后里區厚里里,-301,381,682,1591,2096,0.8,黃金益,無
臺中市后里區后里里,-3,629,632,2705,3542,0.8,楊春明,無
臺中市后里區墩北里,253,605,352,2591,3474,0.7,羅金浩,無
臺中市后里區墩南里,62,584,522,2513,3322,0.8,陳輝,無
臺中市后里區墩東里,88,811,723,3464,4630,0.7,傅鈺婷,無
臺中市后里區墩西里,-228,295,523,1344,1883,0.7,紀廷芳,無
臺中市后里區太平里,-327,360,687,1502,2050,0.7,黃士瑋,無
臺中市后里區廣福里,-296,299,595,1388,1992,0.7,郭明洲,中國國民黨
臺中市后里區月眉里,-309,326,635,1443,1950,0.7,吳新春,無
臺中市后里區泰安里,-214,239,453,1025,1382,0.7,謝學和,無
臺中市后里區眉山里,334,618,284,2396,3221,0.7,潘錦致,無
臺中市后里區義德里,-261,395,656,1786,2465,0.7,謝榮慶,無
臺中市后里區義里里,100,498,398,2193,2968,0.7,林東成,無
臺中市后里區聯合里,-96,264,360,1122,1547,0.7,陳查某,無
臺中市后里區舊社里,3,420,417,1651,2197,0.8,林有盛,無
臺中市和平區中坑里,-250,64,314,344,448,0.8,李明毅,無
臺中市和平區南勢里,-152,235,387,1314,1864,0.7,蔡金火,無
臺中市和平區博愛里,-265,167,432,1071,1567,0.7,范忠文,無
臺中市和平區天輪里,-132,57,189,326,445,0.7,張睿碧,無
臺中市和平區平等里,-349,73,422,523,886,0.6,梁韶陽,無
臺中市和平區梨山里,-41,152,193,1016,1928,0.5,張守宏,無
臺中市和平區自由里,-57,141,198,757,1056,0.7,張弘承,無
臺中市和平區達觀里,-137,113,250,796,1109,0.7,吳振福,無
臺中市外埔區三崁里,-209,301,510,1314,1842,0.7,林月草,無
臺中市外埔區中山里,-569,239,808,887,1164,0.8,張素惠,無
臺中市外埔區六分里,-191,414,605,1604,2144,0.7,劉黃碧霞,無
臺中市外埔區土城里,-361,202,563,1137,1486,0.8,鄭興川,無
臺中市外埔區大同里,80,851,771,3400,4520,0.8,林益年,無
臺中市外埔區大東里,373,1191,818,4551,6183,0.7,高芳春,無
臺中市外埔區廍子里,-669,173,842,787,1112,0.7,廖泰祥,無
臺中市外埔區水美里,270,668,398,2452,3301,0.7,許蓮美,無
臺中市外埔區永豐里,-340,203,543,767,1057,0.7,洪俊義,無
臺中市外埔區鐵山里,-437,348,785,1462,2083,0.7,劉圳,無
臺中市外埔區馬鳴里,-544,224,768,953,1314,0.7,顏慶慰,無
臺中市大安區中庄里,-350,415,765,1771,2542,0.7,莊明堯,無
臺中市大安區南埔里,-396,142,538,679,987,0.7,林恭,無
臺中市大安區南庄里,-371,160,531,686,960,0.7,陳炳煌,無
臺中市大安區東安里,-537,194,731,899,1173,0.8,黃為德,無
臺中市大安區松雅里,-220,202,422,755,970,0.8,張鐿騰,無
臺中市大安區永安里,109,284,175,1198,1673,0.7,卓江山,無
臺中市大安區海墘里,-168,239,407,947,1338,0.7,王勝宗,無
臺中市大安區福住里,-236,167,403,730,1038,0.7,吳添福,無
臺中市大安區福興里,-454,187,641,790,1086,0.7,林正岳,無
臺中市大安區西安里,-79,308,387,1212,1668,0.7,紀木淵,無
臺中市大安區頂安里,-477,130,607,618,850,0.7,陳麗涓,無
臺中市大安區龜壳里,-177,237,414,1031,1429,0.7,洪正義,無
臺中市大甲區中山里,463,908,445,3376,4594,0.7,廖嘉佐,中國國民黨
臺中市大甲區南陽里,-336,128,464,570,777,0.7,黃火塗,無
臺中市大甲區大甲里,-371,152,523,697,924,0.8,黃勝裕,無
臺中市大甲區太白里,-639,169,808,844,1155,0.7,游招滿,民主進步黨
臺中市大甲區奉化里,128,401,273,1484,1961,0.8,白見發,無
臺中市大甲區孔門里,-106,108,214,466,718,0.6,吳柏坤,無
臺中市大甲區孟春里,-123,630,753,2713,3822,0.7,黃湘榕,無
臺中市大甲區岷山里,-308,359,667,1468,1990,0.7,林清良,無
臺中市大甲區平安里,-251,317,568,1425,1919,0.7,周寶惜,無
臺中市大甲區幸福里,-49,389,438,1699,2434,0.7,林晨彬,無
臺中市大甲區庄美里,-150,367,517,1527,1990,0.8,魏李嫌,無
臺中市大甲區建興里,-791,211,1002,1000,1395,0.7,蔡明河,無
臺中市大甲區德化里,-120,329,449,1259,1681,0.7,李柄杉,無
臺中市大甲區文曲里,-374,143,517,714,1040,0.7,林寶彩,無
臺中市大甲區文武里,471,981,510,3834,5106,0.8,葉淑惠,民主進步黨
臺中市大甲區新美里,4,568,564,2398,3194,0.8,王生源,無
臺中市大甲區日南里,572,971,399,3837,5380,0.7,邱大豪,無
臺中市大甲區朝陽里,-151,218,369,935,1258,0.7,林立偉,無
臺中市大甲區武曲里,-150,356,506,1313,1728,0.8,蘇月鳳,無
臺中市大甲區武陵里,-382,193,575,832,1124,0.7,方如玉,無
臺中市大甲區江南里,-410,251,661,946,1331,0.7,李文登,無
臺中市大甲區福德里,-452,169,621,755,1056,0.7,莊金波,無
臺中市大甲區義和里,-433,632,1065,2352,3119,0.8,洪黃素貞,無
臺中市大甲區薰風里,-404,131,535,674,862,0.8,王秋芬,無
臺中市大甲區西岐里,-143,290,433,1211,1622,0.7,羅永宗,無
臺中市大甲區銅安里,-645,221,866,924,1311,0.7,林玉生,無
臺中市大甲區頂店里,281,825,544,3260,4382,0.7,黃安鎮,無
臺中市大甲區順天里,-50,221,271,1056,1458,0.7,陳威宇,無
臺中市大甲區龍泉里,-167,231,398,1044,1432,0.7,陳廷旺,無
臺中市大肚區中和里,-471,152,623,639,833,0.8,陳怡均,無
臺中市大肚區大東里,-139,477,616,2193,2921,0.8,趙政忠,無
臺中市大肚區大肚里,-389,377,766,1648,2095,0.8,陳銘潭,無
臺中市大肚區山陽里,-313,202,515,955,1271,0.8,黃冠陽,無
臺中市大肚區成功里,-288,164,452,712,911,0.8,陳新座,無
臺中市大肚區新興里,-159,337,496,1875,2524,0.7,林華龍,無
臺中市大肚區永和里,-330,93,423,586,782,0.7,劉文芳,無
臺中市大肚區永順里,-359,274,633,1273,1650,0.8,陳秋益,無
臺中市大肚區營埔里,-550,253,803,1081,1457,0.7,楊宗吉,無
臺中市大肚區王田里,91,763,672,3170,4233,0.7,孫清海,無
臺中市大肚區瑞井里,555,903,348,3756,5133,0.7,洪忠祿,無
臺中市大肚區磺溪里,-410,297,707,1276,1657,0.8,趙奕忻,無
臺中市大肚區社腳里,-172,412,584,1808,2324,0.8,陳榮銀,無
臺中市大肚區福山里,-111,528,639,2558,3380,0.8,林弘岳,無
臺中市大肚區自強里,58,521,463,2404,3338,0.7,林順安,中國國民黨
臺中市大肚區蔗廍里,160,851,691,3576,4969,0.7,林進朝,無
臺中市大肚區頂街里,714,1296,582,5417,7311,0.7,陳武徹,無
臺中市大里區中新里,621,1079,458,3852,5312,0.7,廖榮木,無
臺中市大里區仁化里,868,1548,680,5916,8108,0.7,陳宗興,無
臺中市大里區仁德里,628,1105,477,4201,5701,0.7,林志忠,無
臺中市大里區健民里,483,965,482,3695,5114,0.7,楊進祿,無
臺中市大里區內新里,1187,1576,389,6036,8207,0.7,林溢源,無
臺中市大里區國光里,473,1094,621,4213,5551,0.8,魏益川,無
臺中市大里區塗城里,695,1383,688,5826,8110,0.7,黃仁耀,中國國民黨
臺中市大里區夏田里,-379,148,527,700,912,0.8,曾盛琪,無
臺中市大里區大元里,37,730,693,2947,3955,0.7,林瑞興,無
臺中市大里區大明里,295,713,418,2978,4111,0.7,詹武典,無
臺中市大里區大里里,62,633,571,2692,3709,0.7,李錫全,無
臺中市大里區新仁里,909,1448,539,5652,7713,0.7,洪家裕,無
臺中市大里區新里里,879,1913,1034,7278,10451,0.7,何世琦,無
臺中市大里區日新里,27,761,734,3222,4246,0.8,顏子,無
臺中市大里區東昇里,109,558,449,2392,3279,0.7,陳進發,無
臺中市大里區東湖里,1199,1865,666,7469,10519,0.7,何天祿,無
臺中市大里區東興里,797,1194,397,5005,6681,0.7,陳進生,無
臺中市大里區樹王里,104,642,538,2683,3564,0.8,陳俞樺,無
臺中市大里區永隆里,1305,2073,768,7648,9756,0.8,林士元,無
臺中市大里區瑞城里,1867,2281,414,8522,11560,0.7,蔡承翰,無
臺中市大里區祥興里,661,1335,674,5303,7318,0.7,黃春海,無
臺中市大里區立仁里,276,984,708,3750,5270,0.7,陳稼松,無
臺中市大里區立德里,801,1534,733,5737,7700,0.7,江慶賢,無
臺中市大里區西榮里,189,945,756,3843,5358,0.7,羅文評,無
臺中市大里區西湖里,-263,443,706,2001,2732,0.7,賴加彬,無
臺中市大里區金城里,883,1670,787,6561,9216,0.7,潘國琦,中國國民黨
臺中市大里區長榮里,776,1623,847,6308,8393,0.8,洪資源,中國國民黨
臺中市大雅區三和里,410,1003,593,3944,5237,0.8,廖顯彬,中國國民黨
臺中市大雅區上楓里,489,1274,785,4714,6290,0.7,鄧兆堂,無
臺中市大雅區上雅里,524,1237,713,4323,6022,0.7,陳映辰,無
臺中市大雅區二和里,331,1168,837,4414,5973,0.7,陳明村,無
臺中市大雅區六寶里,618,1013,395,4311,5992,0.7,張嘉榮,無
臺中市大雅區員林里,854,1830,976,6952,9146,0.8,張本侒,無
臺中市大雅區四德里,133,896,763,3329,4435,0.8,呂啟勳,無
臺中市大雅區大楓里,512,886,374,3575,4930,0.7,蔡界地,無
臺中市大雅區大雅里,35,722,687,3203,4233,0.8,李玲珍,無
臺中市大雅區忠義里,-225,504,729,2490,3541,0.7,林義木,中國國民黨
臺中市大雅區文雅里,413,1117,704,4290,5879,0.7,賴福林,無
臺中市大雅區橫山里,177,827,650,3181,4207,0.8,張聖河,無
臺中市大雅區秀山里,199,574,375,2489,3289,0.8,張嘉宏,無
臺中市大雅區西寶里,162,825,663,3371,4706,0.7,劉孝民,無
臺中市大雅區雅楓里,124,566,442,2426,3419,0.7,張東開,無
臺中市太平區中山里,-194,465,659,2180,3812,0.6,閻泰利,中國國民黨
臺中市太平區中平里,31,656,625,2811,3928,0.7,林碧森,無
臺中市太平區中政里,49,559,510,2449,3523,0.7,林宗慶,無
臺中市太平區中興里,36,531,495,2250,3069,0.7,林阿爐,無
臺中市太平區光明里,18,603,585,2624,3774,0.7,胥樹文,中國國民黨
臺中市太平區光華里,318,810,492,3723,5194,0.7,黃鐵騫,無
臺中市太平區光隆里,-187,493,680,2150,2991,0.7,張雅芳,無
臺中市太平區勤益里,-279,340,619,1504,2107,0.7,馮耀祖,中國國民黨
臺中市太平區坪林里,160,482,322,2320,3181,0.7,賴啓誠,中國國民黨
臺中市太平區大興里,-190,391,581,1722,2484,0.7,鄭金川,無
臺中市太平區太平里,435,825,390,3651,5075,0.7,林龍洲,無
臺中市太平區宜佳里,476,1076,600,4216,5966,0.7,張麗眞,無
臺中市太平區宜昌里,328,797,469,3009,4325,0.7,林進發,無
臺中市太平區宜欣里,373,984,611,4289,6140,0.7,楊登圳,中國國民黨
臺中市太平區平安里,-112,352,464,1530,2114,0.7,施秀彩,無
臺中市太平區建國里,-239,449,688,1979,2803,0.7,江德海,中國國民黨
臺中市太平區建興里,-192,384,576,1848,2803,0.7,胡長志,中國國民黨
臺中市太平區德隆里,118,828,710,3323,4730,0.7,吳燕明,無
臺中市太平區成功里,-21,684,705,2647,3810,0.7,洪大鈞,無
臺中市太平區新光里,696,1404,708,5513,7502,0.7,游癸龍,無
臺中市太平區新吉里,693,1182,489,4163,5612,0.7,黃天財,無
臺中市太平區新坪里,1082,1479,397,5539,7738,0.7,紀進豐,無
臺中市太平區新城里,724,1176,452,4054,5905,0.7,胡錩宏,無
臺中市太平區新福里,700,1379,679,5073,6939,0.7,李子濬,無
臺中市太平區新興里,625,1453,828,4662,6121,0.8,李建民,無
臺中市太平區新高里,1402,2048,646,6614,8838,0.7,江姿樺,無
臺中市太平區東和里,-149,457,606,1900,2738,0.7,賴來旺,無
臺中市太平區東平里,-5,714,719,2852,4036,0.7,温錦昌,無
臺中市太平區東汴里,-439,139,578,764,1125,0.7,呂坤龍,無
臺中市太平區永平里,341,734,393,2858,4004,0.7,賴義涼,無
臺中市太平區永成里,856,1273,417,4925,6773,0.7,陳秋蟬,無
臺中市太平區永隆里,-365,405,770,1788,2436,0.7,張立緯,無
臺中市太平區福隆里,208,559,351,2533,3545,0.7,黃楷能,無
臺中市太平區聖和里,-687,213,900,1057,1503,0.7,劉佳明,無
臺中市太平區興隆里,-133,464,597,2191,3145,0.7,張閔南,無
臺中市太平區豐年里,-14,651,665,3112,4214,0.7,劉盈欣,無
臺中市太平區長億里,485,1188,703,4677,6296,0.7,呂也好,無
臺中市太平區頭汴里,-131,207,338,1186,1746,0.7,江思涵,無
臺中市太平區黃竹里,-300,72,372,435,600,0.7,林元成,無
臺中市新社區中和里,-283,60,343,406,539,0.8,鄭文章,無
臺中市新社區中正里,-570,218,788,976,1331,0.7,張鳳梅,無
臺中市新社區中興里,-240,55,295,440,584,0.8,李劉秀雲,中國國民黨
臺中市新社區協成里,-149,374,523,1987,2791,0.7,王再興,無
臺中市新社區大南里,-347,228,575,1283,1791,0.7,黃逸峯,無
臺中市新社區崑山里,-535,148,683,825,1100,0.8,廖銘洲,無
臺中市新社區復盛里,-191,283,474,1240,1746,0.7,柯廷蓁,無
臺中市新社區慶西里,-372,108,480,602,857,0.7,蔡嘉宜,無
臺中市新社區新社里,-131,507,638,2375,3145,0.8,黃正光,無
臺中市新社區月湖里,-456,125,581,693,968,0.7,高清源,無
臺中市新社區東興里,-322,161,483,834,1166,0.7,張文明,無
臺中市新社區永源里,-129,413,542,2181,2853,0.8,蘇東波,無
臺中市新社區福興里,-41,95,136,741,1080,0.7,劉春財,無
臺中市東勢區上城里,-400,139,539,694,922,0.8,張玉雲,無
臺中市東勢區上新里,-229,127,356,700,907,0.8,王綉滿,中國國民黨
臺中市東勢區下城里,-369,93,462,583,810,0.7,劉海湖,無
臺中市東勢區下新里,-59,226,285,1152,1577,0.7,詹前貴,無
臺中市東勢區中寧里,-445,117,562,568,793,0.7,廖歆,無
臺中市東勢區中嵙里,-88,251,339,1266,1781,0.7,王鎭樑,無
臺中市東勢區北興里,-618,204,822,949,1377,0.7,李德興,無
臺中市東勢區南平里,-225,245,470,1263,1681,0.8,黃文茂,無
臺中市東勢區埤頭里,-359,98,457,481,636,0.8,林坤詮,無
臺中市東勢區廣興里,-503,177,680,961,1330,0.7,廖紫台,無
臺中市東勢區延平里,-292,280,572,1491,2044,0.7,吳文龍,無
臺中市東勢區慶東里,-220,229,449,1303,1778,0.7,黃國修,無
臺中市東勢區慶福里,-474,142,616,778,1177,0.7,林金泉,無
臺中市東勢區新盛里,23,741,718,3478,4713,0.7,吳進聰,無
臺中市東勢區明正里,-400,155,555,894,1297,0.7,吳萬明,無
臺中市東勢區東安里,-416,130,546,696,962,0.7,楊嘉裕,無
臺中市東勢區東新里,-106,301,407,1469,1929,0.8,余運來,無
臺中市東勢區泰昌里,-138,461,599,2376,3229,0.7,徐鎮富,無
臺中市東勢區泰興里,-298,89,387,498,688,0.7,江國豐,無
臺中市東勢區福隆里,-176,523,699,2633,3639,0.7,林品巧,無
臺中市東勢區粵寧里,-476,273,749,1441,1933,0.7,詹德旺,無
臺中市東勢區興隆里,-268,146,414,801,1125,0.7,徐錦全,無
臺中市東勢區茂興里,-233,243,476,1257,1774,0.7,吳仁文,無
臺中市東勢區詒福里,-134,207,341,1132,1544,0.7,郭丞漢,無
臺中市東勢區隆興里,-530,165,695,967,1368,0.7,蘇清泉,無
臺中市東區十甲里,309,856,547,3577,4832,0.7,林昑照,無
臺中市東區合作里,-63,673,736,2797,3890,0.7,曾建成,中國國民黨
臺中市東區富仁里,292,572,280,2804,3915,0.7,施文海,中國國民黨
臺中市東區富台里,-226,234,460,1176,1668,0.7,石國勳,中國國民黨
臺中市東區干城里,-117,370,487,1630,2139,0.8,張碧芝,無
臺中市東區振興里,117,437,320,2185,2942,0.7,劉作文,無
臺中市東區新庄里,-18,394,412,1816,2893,0.6,洪宗毅,無
臺中市東區旱溪里,-29,365,394,1813,2404,0.8,郭松益,無
臺中市東區東信里,1053,1484,431,6561,8647,0.8,洪榮吉,無
臺中市東區東勢里,-213,386,599,1775,2542,0.7,張財良,中國國民黨
臺中市東區東南里,32,620,588,2717,3736,0.7,王瑞發,中國國民黨
臺中市東區東橋里,153,594,441,2714,3613,0.8,何冠緯,無
臺中市東區東興里,-412,487,899,2122,2764,0.8,宋茂榮,中國國民黨
臺中市東區東英里,661,1390,729,5695,7450,0.8,林德興,無
臺中市東區東門里,1087,1374,287,5429,7062,0.8,莊錦聰,無
臺中市東區樂成里,-159,387,546,1716,2378,0.7,曾仁杰,無
臺中市東區泉源里,-207,341,548,1544,2042,0.8,羅文甫,無
臺中市梧棲區下寮里,-64,322,386,1412,1920,0.7,許福順,無
臺中市梧棲區中和里,-253,59,312,349,471,0.7,林淑貞,無
臺中市梧棲區中正里,-160,628,788,2637,3727,0.7,林祝女,無
臺中市梧棲區南簡里,619,1126,507,4084,5587,0.7,蔡佳君,無
臺中市梧棲區大庄里,600,1462,862,5581,7670,0.7,楊維智,無
臺中市梧棲區大村里,241,1086,845,4117,5630,0.7,陳昆廷,無
臺中市梧棲區安仁里,-282,120,402,518,728,0.7,薛志富,無
臺中市梧棲區文化里,-506,183,689,832,1109,0.8,蔡傳枝,無
臺中市梧棲區永安里,-242,393,635,1737,2438,0.7,王連松,無
臺中市梧棲區永寧里,-307,345,652,1622,2225,0.7,李皆得,無
臺中市梧棲區福德里,527,1019,492,3706,5145,0.7,紀建豪,無
臺中市梧棲區興農里,-232,476,708,1809,2503,0.7,陳起益,無
臺中市梧棲區草湳里,479,1179,700,4473,6004,0.7,林槐庭,無
臺中市梧棲區頂寮里,112,752,640,2761,3901,0.7,鐘金水,無
臺中市沙鹿區三鹿里,1041,1655,614,5610,7570,0.7,顏清通,無
臺中市沙鹿區公明里,99,778,679,3125,4276,0.7,蔡水松,無
臺中市沙鹿區六路里,799,1229,430,4146,5545,0.7,陳永祥,無
臺中市沙鹿區北勢里,547,1013,466,3689,5013,0.7,陳科求,無
臺中市沙鹿區南勢里,224,732,508,2585,3330,0.8,王愷,無
臺中市沙鹿區埔子里,784,1347,563,4686,6012,0.8,蔡伶青,無
臺中市沙鹿區居仁里,-100,218,318,953,1268,0.8,黃月兒,無
臺中市沙鹿區斗抵里,472,878,406,3461,4476,0.8,王宏書,無
臺中市沙鹿區晉江里,-206,325,531,1335,1751,0.8,李瑞珍,無
臺中市沙鹿區沙鹿里,-405,99,504,632,847,0.7,蔡曉婷,無
臺中市沙鹿區洛泉里,-493,289,782,1440,1859,0.8,黃金,無
臺中市沙鹿區清泉里,-152,450,602,1774,2310,0.8,蔡國欣,無
臺中市沙鹿區犁分里,-351,204,555,819,1082,0.8,陳文宜,無
臺中市沙鹿區福興里,141,794,653,3004,3889,0.8,蔣木林,無
臺中市沙鹿區竹林里,1029,1413,384,5610,7603,0.7,陳吉成,無
臺中市沙鹿區美仁里,-193,69,262,342,454,0.8,陳建良,無
臺中市沙鹿區興仁里,-49,406,455,1824,2363,0.8,劉驊慶,無
臺中市沙鹿區興安里,360,654,294,2488,3343,0.7,白來清,無
臺中市沙鹿區西勢里,-261,327,588,1504,2012,0.7,蔡坤地,無
臺中市沙鹿區鹿寮里,889,1310,421,5424,6988,0.8,王榮正,無
臺中市沙鹿區鹿峰里,594,1138,544,4375,5750,0.8,白淞元,無
臺中市清水區下湳里,-545,431,976,1966,2676,0.7,李王玉蘭,無
臺中市清水區中社里,-207,503,710,2072,2775,0.7,王瑜蘭,中國國民黨
臺中市清水區中興里,-224,65,289,297,372,0.8,蔡興達,無
臺中市清水區北寧里,-305,92,397,506,658,0.8,紀文來,中國國民黨
臺中市清水區南寧里,-191,290,481,1264,1703,0.7,高志勇,無
臺中市清水區南社里,1100,1971,871,7564,10146,0.7,崔惠國,無
臺中市清水區吳厝里,-655,222,877,1071,1417,0.8,吳水通,無
臺中市清水區國姓里,-320,262,582,1327,1938,0.7,黃秀英,無
臺中市清水區文昌里,-334,90,424,462,611,0.8,楊介猶,無
臺中市清水區東山里,-483,181,664,820,1160,0.7,王偉權,無
臺中市清水區楊厝里,-488,182,670,773,1082,0.7,曾弘利,無
臺中市清水區槺榔里,993,1736,743,5678,8210,0.7,洪水家,無
臺中市清水區橋頭里,562,1332,770,5477,7275,0.8,林瑶卿,無
臺中市清水區武鹿里,118,576,458,2562,3514,0.7,陳志一,無
臺中市清水區海濱里,-303,313,616,1535,2085,0.7,陳山林,無
臺中市清水區海風里,-566,250,816,1012,1352,0.7,黃堉睿,無
臺中市清水區清水里,-35,442,477,1698,2330,0.7,陳安吉,無
臺中市清水區田寮里,-120,372,492,1607,2362,0.7,許進興,無
臺中市清水區秀水里,260,774,514,3231,4377,0.7,陳月娟,無
臺中市清水區臨江里,-657,206,863,1055,1444,0.7,洪敏哲,無
臺中市清水區菁埔里,-44,353,397,1604,2154,0.7,林子清,無
臺中市清水區裕嘉里,-289,218,507,990,1374,0.7,陳瑞欽,無
臺中市清水區西寧里,-695,227,922,1106,1488,0.7,王慶源,無
臺中市清水區西社里,-17,352,369,1618,2129,0.8,楊茂雄,無
臺中市清水區靈泉里,-368,139,507,674,871,0.8,顏貽松,無
臺中市清水區頂湳里,-385,260,645,1238,1691,0.7,王景收,無
臺中市清水區高北里,-510,151,661,718,1110,0.6,白銀堂,無
臺中市清水區高南里,-555,179,734,838,1237,0.7,楊忠銘,無
臺中市清水區高東里,-626,188,814,839,1173,0.7,蔡榮聰,無
臺中市清水區高美里,-352,179,531,902,1263,0.7,洪瑞晟,無
臺中市清水區高西里,-582,161,743,854,1230,0.7,洪曜南,無
臺中市清水區鰲峰里,-578,141,719,769,1032,0.7,蔡裕生,無
臺中市潭子區嘉仁里,179,683,504,2941,3932,0.7,林瑞文,無
臺中市潭子區大富里,-178,540,718,2206,2881,0.8,林啓彬,無
臺中市潭子區大豐里,291,1198,907,4526,5993,0.8,蕭清柏,無
臺中市潭子區家福里,508,950,442,3505,4586,0.8,鄭朝元,中國國民黨
臺中市潭子區家興里,951,1314,363,5048,6761,0.7,莊世雄,無
臺中市潭子區新田里,-556,222,778,1105,1489,0.7,吳政潭,無
臺中市潭子區東寶里,1440,2127,687,8763,11805,0.7,林銘泉,無
臺中市潭子區栗林里,492,859,367,3654,4824,0.8,簡順雄,無
臺中市潭子區潭北里,-190,427,617,1831,2430,0.8,林俊堂,無
臺中市潭子區潭秀里,-603,219,822,932,1207,0.8,陳健峯,無
臺中市潭子區潭陽里,1297,1897,600,7758,10572,0.7,楊仲傑,無
臺中市潭子區甘蔗里,1223,1842,619,6909,9288,0.7,黃正堯,中國國民黨
臺中市潭子區福仁里,1442,1898,456,7660,10481,0.7,游豐瑋,無
臺中市潭子區聚興里,-21,623,644,2833,4231,0.7,林信士,無
臺中市潭子區頭家東里,192,747,555,3150,4239,0.7,劉進福,中國國民黨
臺中市潭子區頭家里,425,1008,583,3963,5267,0.8,黃聖明,中國國民黨
臺中市烏日區三和里,1327,1711,384,5744,7847,0.7,楊添和,無
臺中市烏日區九德里,1684,2161,477,9265,12310,0.8,陳美香,無
臺中市烏日區五光里,-373,289,662,1272,1660,0.8,林榮源,無
臺中市烏日區仁德里,649,1331,682,5671,7442,0.8,洪炳煌,中國國民黨
臺中市烏日區光明里,-235,351,586,1559,2041,0.8,賴信忠,無
臺中市烏日區前竹里,-327,251,578,1185,1523,0.8,林東潭,無
臺中市烏日區北里里,-565,242,807,1229,1588,0.8,魏周森,無
臺中市烏日區南里里,-520,246,766,1019,1313,0.8,蔡敏陽,無
臺中市烏日區學田里,-335,440,775,1900,2562,0.7,孫禾昀,無
臺中市烏日區東園里,70,426,356,1720,2226,0.8,張有城,無
臺中市烏日區榮泉里,731,1446,715,4840,6348,0.8,何聰智,無
臺中市烏日區湖日里,-326,488,814,1980,2728,0.7,楊來成,無
臺中市烏日區溪埧里,-107,729,836,3358,4323,0.8,陳登正,無
臺中市烏日區溪尾里,-212,141,353,598,798,0.7,顏寶玉,無
臺中市烏日區烏日里,921,1625,704,6568,8494,0.8,陳新安,無
臺中市烏日區螺潭里,-356,366,722,1678,2106,0.8,林國貞,無
臺中市石岡區九房里,-452,181,633,878,1178,0.7,張鴻斌,民主進步黨
臺中市石岡區和盛里,-491,169,660,872,1181,0.7,何賴財桂,無
臺中市石岡區土牛里,-247,130,377,696,980,0.7,管德財,無
臺中市石岡區德興里,-696,180,876,957,1334,0.7,劉紀雄,無
臺中市石岡區梅子里,-440,250,690,1294,1750,0.7,郭光勇,無
臺中市石岡區石岡里,-652,181,833,853,1143,0.7,陸永晟,無
臺中市石岡區萬安里,-699,249,948,1158,1488,0.8,林子晏,無
臺中市石岡區萬興里,-330,219,549,1073,1388,0.8,羅益洲,無
臺中市石岡區金星里,-648,136,784,855,1174,0.7,李淑惠,無
臺中市石岡區龍興里,-309,75,384,442,604,0.7,黃清標,無
臺中市神岡區三角里,-342,443,785,1963,2556,0.8,江炳煌,無
臺中市神岡區北庄里,-350,446,796,1962,2549,0.8,王秋生,無
臺中市神岡區圳前里,-114,350,464,1596,2191,0.7,陳木生,中國國民黨
臺中市神岡區圳堵里,-360,357,717,1525,2038,0.7,鄭秀燕,無
臺中市神岡區大社里,435,839,404,3172,4369,0.7,高元平,無
臺中市神岡區山皮里,-431,156,587,754,981,0.8,陳勝泧,民主進步黨
臺中市神岡區岸裡里,-230,438,668,2100,2775,0.8,謝繼潭,無
臺中市神岡區庄前里,-116,429,545,1719,2214,0.8,張鎮正,無
臺中市神岡區庄後里,-13,350,363,1661,2162,0.8,林美玲,無
臺中市神岡區新庄里,167,671,504,2868,4007,0.7,張育豪,無
臺中市神岡區溪洲里,-275,456,731,2077,2711,0.8,王明洲,無
臺中市神岡區社南里,605,1005,400,3855,5097,0.8,楊春福,民主進步黨
臺中市神岡區社口里,915,1415,500,5548,7475,0.7,陳金地,無
臺中市神岡區神岡里,37,529,492,2241,3073,0.7,王百瀛,無
臺中市神岡區神洲里,-426,416,842,1858,2436,0.8,陳大燿,無
臺中市神岡區豐洲里,593,1164,571,5155,6949,0.7,王文松,無
臺中市西區三民里,-135,256,391,1247,2314,0.5,廖吳芬芳,無
臺中市西區中興里,-136,533,669,2623,3462,0.8,湯鈞任,無
臺中市西區公平里,234,818,584,3616,4940,0.7,魏素眞,中國國民黨
臺中市西區公德里,-67,743,810,3147,4183,0.8,楊博文,中國國民黨
臺中市西區公正里,638,1147,509,4733,6212,0.8,林哲雄,中國國民黨
臺中市西區公民里,135,740,605,3538,4724,0.7,林鈞陶,無
臺中市西區公益里,-234,439,673,1984,2640,0.8,劉興峰,無
臺中市西區公舘里,452,901,449,4053,5464,0.7,謝錫宏,無
臺中市西區利民里,-510,204,714,956,1282,0.7,陳敏祥,中國國民黨
臺中市西區双龍里,-218,401,619,1925,2639,0.7,林坤泉,中國國民黨
臺中市西區吉龍里,745,1071,326,4695,6287,0.7,李國禎,無
臺中市西區和龍里,-224,331,555,1566,2199,0.7,孟慶華,無
臺中市西區土庫里,459,857,398,4074,5451,0.7,粟藍倩,無
臺中市西區大忠里,297,803,506,3344,4237,0.8,張智權,無
臺中市西區安龍里,-316,430,746,2022,2707,0.7,賴梁松,無
臺中市西區平和里,-156,297,453,1268,1771,0.7,張洪惠雪,中國國民黨
臺中市西區廣民里,-473,195,668,960,1329,0.7,林水順,無
臺中市西區後龍里,-90,515,605,2416,3277,0.7,郭耀泉,無
臺中市西區忠明里,369,877,508,4078,5606,0.7,賴瑞滄,無
臺中市西區忠誠里,361,883,522,4006,5427,0.7,趙瑞豐,無
臺中市西區昇平里,237,930,693,4051,5472,0.7,蕭行凱,無
臺中市西區東昇里,-180,347,527,1640,2127,0.8,徐耀鍾,無
臺中市西區民生里,-145,272,417,1252,1677,0.7,黃文濱,中國國民黨
臺中市西區民龍里,213,626,413,2548,3473,0.7,吳國楨,中國國民黨
臺中市西區藍興里,225,700,475,3057,3883,0.8,黃富榮,無
臺中市西屯區上安里,643,1016,373,3860,5206,0.7,賴耀熙,無
臺中市西屯區上德里,47,689,642,3008,4074,0.7,洪頊晿,無
臺中市西屯區上石里,615,1055,440,3676,5013,0.7,馮華昌,中國國民黨
臺中市西屯區何仁里,590,1125,535,4469,5989,0.7,蔡翔宇,無
臺中市西屯區何南里,152,731,579,3053,4028,0.8,曹豐洋,無
臺中市西屯區何厝里,32,527,495,2231,3100,0.7,何劉美玲,無
臺中市西屯區何安里,432,991,559,4147,5725,0.7,何唐文鈴,無
臺中市西屯區何德里,24,676,652,2722,3608,0.8,林志雄,無
臺中市西屯區何成里,545,1104,559,4637,6255,0.7,田貴玉,無
臺中市西屯區何明里,10,560,550,2567,3394,0.8,趙淑妙,無
臺中市西屯區何源里,562,1178,616,4798,6477,0.7,彭琴安,中國國民黨
臺中市西屯區何福里,265,742,477,3195,4216,0.8,何淑玲,民主進步黨
臺中市西屯區協和里,196,849,653,3342,4556,0.7,陳靖益,無
臺中市西屯區大河里,-137,628,765,2922,3771,0.8,陳資源,無
臺中市西屯區大石里,-287,327,614,1612,2124,0.8,吳忠華,中國國民黨
臺中市西屯區大福里,-61,517,578,2224,3222,0.7,高信增,中國國民黨
臺中市西屯區大鵬里,319,786,467,3353,4574,0.7,邱清涼,中國國民黨
臺中市西屯區廣福里,-230,332,562,1681,2191,0.8,吳賢龍,無
臺中市西屯區惠來里,2215,2573,358,11086,15385,0.7,廖慶麟,無
臺中市西屯區林厝里,149,629,480,2512,3395,0.7,余進卿,中國國民黨
臺中市西屯區永安里,2242,2548,306,8960,12509,0.7,張阿淑,中國國民黨
臺中市西屯區港尾里,338,885,547,3677,4970,0.7,楊忠義,無
臺中市西屯區潮洋里,470,1107,637,4309,6776,0.6,陳素貞,無
臺中市西屯區福中里,288,588,300,2334,3163,0.7,廖阿月,中國國民黨
臺中市西屯區福和里,286,756,470,3108,4215,0.7,林寅利,無
臺中市西屯區福安里,-206,625,831,2274,2995,0.8,張清和,無
臺中市西屯區福恩里,659,991,332,3616,4765,0.8,陳桂香,中國國民黨
臺中市西屯區福林里,1189,1598,409,5746,7723,0.7,林柏翰,無
臺中市西屯區福瑞里,-54,552,606,2069,2952,0.7,林添憶,中國國民黨
臺中市西屯區福聯里,-6,602,608,2222,3307,0.7,馮進通,無
臺中市西屯區福雅里,470,1160,690,4266,5741,0.7,王勝偉,中國國民黨
臺中市西屯區至善里,93,793,700,3223,4335,0.7,鄭文昌,無
臺中市西屯區西墩里,811,1186,375,4589,6092,0.8,廖家慧,無
臺中市西屯區西安里,483,1156,673,4080,5428,0.8,徐文電,無
臺中市西屯區西平里,293,828,535,3391,4842,0.7,廖建森,中國國民黨
臺中市西屯區逢甲里,132,862,730,3334,4583,0.7,廖婉菁,無
臺中市西屯區逢福里,394,916,522,3885,5203,0.7,張文平,無
臺中市西屯區鵬程里,-95,343,438,1822,2487,0.7,陳文聿,中國國民黨
臺中市西屯區龍潭里,-212,172,384,754,1004,0.8,張清文,無
臺中市豐原區三村里,700,1140,440,4634,6081,0.8,許全木,無
臺中市豐原區下街里,-65,146,211,570,744,0.8,林貴榮,無
臺中市豐原區中山里,-234,121,355,609,772,0.8,林榮一,無
臺中市豐原區中興里,-304,509,813,2089,2822,0.7,魏丞章,無
臺中市豐原區中陽里,261,906,645,3935,5087,0.8,黃英瑜,無
臺中市豐原區北湳里,76,566,490,2312,3000,0.8,黃文亮,無
臺中市豐原區北陽里,1880,2309,429,9699,12770,0.8,林昆民,無
臺中市豐原區南嵩里,201,552,351,2428,3251,0.7,劉玉玲,無
臺中市豐原區南村里,196,988,792,3924,5225,0.8,謝見忠,無
臺中市豐原區南田里,-44,544,588,2323,3102,0.7,劉醇權,無
臺中市豐原區南陽里,1367,1939,572,7769,10371,0.7,楊國勝,無
臺中市豐原區圳寮里,-676,213,889,936,1186,0.8,陳坤湖,無
臺中市豐原區大湳里,-145,429,574,1794,2419,0.7,張鳳茹,無
臺中市豐原區富春里,-355,91,446,529,662,0.8,陳麗鳳,無
臺中市豐原區朴子里,-171,560,731,2422,3196,0.8,陳文啓,無
臺中市豐原區東勢里,-577,189,766,1000,1369,0.7,胡慧玲,無
臺中市豐原區東湳里,188,698,510,2969,3896,0.8,唐志勇,無
臺中市豐原區東陽里,-767,214,981,1171,1508,0.8,張德勲,無
臺中市豐原區民生里,-183,175,358,791,1069,0.7,吳俊德,無
臺中市豐原區田心里,337,1023,686,4255,6128,0.7,徐倍基,無
臺中市豐原區社皮里,1169,1778,609,7127,9626,0.7,涂力旋,中國國民黨
臺中市豐原區翁子里,-49,585,634,2403,3204,0.8,連佳振,無
臺中市豐原區翁明里,68,463,395,1702,2213,0.8,高銘傳,無
臺中市豐原區翁社里,-298,326,624,1517,1993,0.8,吳安修,無
臺中市豐原區葫蘆里,-116,85,201,428,576,0.7,王彥閔,無
臺中市豐原區西勢里,19,360,341,1622,2102,0.8,王建清,無
臺中市豐原區西安里,440,863,423,3569,4651,0.8,羅茂榮,無
臺中市豐原區西湳里,1075,1778,703,6868,9105,0.8,蔣年峯,無
臺中市豐原區豐原里,-159,349,508,1568,2191,0.7,洪源隆,無
臺中市豐原區豐圳里,-81,593,674,2496,3220,0.8,鄭文鑫,無
臺中市豐原區豐榮里,-395,162,557,779,1052,0.7,林金玉,無
臺中市豐原區豐田里,847,1715,868,7408,9949,0.7,劉瑞銓,中國國民黨
臺中市豐原區豐西里,-104,274,378,1200,1571,0.8,葉明昌,無
臺中市豐原區鎌村里,-225,758,983,3427,4493,0.8,林隆源,無
臺中市豐原區陽明里,-13,456,469,1991,2551,0.8,鄧年益,無
臺中市豐原區頂街里,-276,135,411,645,886,0.7,吳令儀,無
臺中市霧峰區丁台里,-417,350,767,1698,2234,0.8,洪耀南,無
臺中市霧峰區中正里,21,354,333,1510,1921,0.8,林進生,無
臺中市霧峰區五福里,-242,425,667,1968,2561,0.8,陳岳彬,無
臺中市霧峰區六股里,-290,356,646,1767,2287,0.8,王原祥,無
臺中市霧峰區北勢里,-273,330,603,1563,1999,0.8,洪金生,無
臺中市霧峰區北柳里,-169,680,849,3020,3909,0.8,吳儒親,無
臺中市霧峰區南勢里,-473,191,664,944,1242,0.8,黃清標,無
臺中市霧峰區南柳里,-28,325,353,1406,1852,0.8,楊國忠,無
臺中市霧峰區吉峰里,943,1459,516,6528,9085,0.7,林政逸,無
臺中市霧峰區四德里,-59,457,516,1794,2443,0.7,紀天富,無
臺中市霧峰區坑口里,137,420,283,2092,2861,0.7,王中興,無
臺中市霧峰區峰谷里,-215,171,386,805,1087,0.7,黃錦昌,無
臺中市霧峰區本堂里,563,970,407,4231,5678,0.7,林錦池,無
臺中市霧峰區本鄉里,-232,370,602,1697,2238,0.8,林揚展,無
臺中市霧峰區桐林里,-345,200,545,925,1179,0.8,林國安,無
臺中市霧峰區甲寅里,418,765,347,3431,4636,0.7,李明忠,無
臺中市霧峰區舊正里,-253,312,565,1496,1996,0.7,張國財,無
臺中市霧峰區萊園里,-508,159,667,761,988,0.8,唐青山,無
臺中市霧峰區萬豐里,-247,342,589,1805,2501,0.7,林麗真,無
臺中市霧峰區錦榮里,-429,195,624,927,1240,0.7,張永昇,無
臺中市龍井區三德里,-194,495,689,2094,2820,0.7,楊易明,無
臺中市龍井區南寮里,-942,238,1180,1222,1498,0.8,林志強,無
臺中市龍井區山腳里,608,1084,476,4188,5705,0.7,陳春雄,無
臺中市龍井區忠和里,427,899,472,3565,4717,0.8,林聰海,無
臺中市龍井區新庄里,545,1126,581,4526,6119,0.7,陳進爵,無
臺中市龍井區新東里,286,833,547,3448,4746,0.7,劉克俊,無
臺中市龍井區東海里,832,1568,736,6287,8523,0.7,林秋蘭,無
臺中市龍井區田中里,223,744,521,2891,3775,0.8,張文慶,無
臺中市龍井區福田里,-546,142,688,712,1009,0.7,歐錦墩,無
臺中市龍井區竹坑里,-60,612,672,2304,3094,0.7,許麗珠,無
臺中市龍井區麗水里,-57,360,417,1618,2159,0.7,陳耀墩,無
臺中市龍井區龍崗里,-159,490,649,2041,2739,0.7,林朝清,無
臺中市龍井區龍東里,56,531,475,2117,2893,0.7,林金鍊,無
臺中市龍井區龍泉里,1091,1484,393,5787,7954,0.7,黃聖龍,無
臺中市龍井區龍津里,499,896,397,3569,4848,0.7,張坤雄,無
臺中市龍井區龍西里,-260,287,547,1330,1751,0.8,黃碧林,無
