村里,2024-2022,2024民眾黨,2022村里長得票,2024投票數,2024選舉人數,2024投票率,里長姓名,里長政黨
臺中市中區中華里,-115,293,408,665,942,70.59,廖榮中,無
臺中市中區光復里,-89,271,360,704,952,73.95,張富星,中國國民黨
臺中市中區公園里,-366,172,538,921,1347,68.37,陳裕明,無
臺中市中區大墩里,-111,274,385,760,1089,69.79,張文華,中國國民黨
臺中市中區大誠里,-327,311,638,730,1018,71.71,林志隆,中國國民黨
臺中市中區柳川里,-125,234,359,673,1194,56.37,蔡翠碧,中國國民黨
臺中市中區綠川里,-355,204,559,1018,1439,70.74,楊文宏,無
臺中市中區繼光里,-298,155,453,979,1408,69.53,吳禎耀,中國國民黨
臺中市北區中正里,-453,167,620,850,1180,72.03,張陳美雲,無
臺中市北區中達里,-38,379,417,940,1314,71.54,賴文進,無
臺中市北區五常里,-418,230,648,879,1255,70.04,林玉惠,無
臺中市北區健行里,354,1097,743,980,1292,75.85,何文宏,中國國民黨
臺中市北區光大里,-3,301,304,720,1045,68.90,朱瑞珠,無
臺中市北區六合里,-540,267,807,1163,1687,68.94,陳豐誠,民主進步黨
臺中市北區大湖里,-19,306,325,688,1000,68.80,紀國華,無
臺中市北區崇德里,126,583,457,781,1096,71.26,呂成地,無
臺中市北區建德里,89,467,378,752,1013,74.23,鄭凱鶴,無
臺中市北區建成里,583,1002,419,961,1244,77.25,林寬仁,無
臺中市北區建興里,375,836,461,827,1158,71.42,王平河,無
臺中市北區文莊里,-300,445,745,657,865,75.95,劉継勇,中國國民黨
臺中市北區新北里,-111,243,354,519,730,71.10,陳信志,中國國民黨
臺中市北區新興里,-168,177,345,514,686,74.93,曹中萍,中國國民黨
臺中市北區明德里,341,903,562,957,1298,73.73,林麗芬,無
臺中市北區明新里,-174,426,600,1008,1334,75.56,洪平東,無
臺中市北區梅川里,-148,567,715,1167,1575,74.10,賴家增,中國國民黨
臺中市北區樂英里,-126,301,427,887,1222,72.59,劉玉琦,中國國民黨
臺中市北區淡溝里,510,848,338,1058,1429,74.04,何文正,中國國民黨
臺中市北區立人里,278,640,362,822,1158,70.98,黃韻化,無
臺中市北區育德里,129,543,414,1081,1475,73.29,黃志銘,無
臺中市北區賴厝里,243,716,473,778,1963,39.63,賴有德,中國國民黨
臺中市北區賴旺里,249,727,478,939,1308,71.79,黃育嘉,無
臺中市北區賴明里,174,637,463,876,1168,75.00,賴茂庭,中國國民黨
臺中市北區賴村里,150,616,466,910,1255,72.51,廖羽婷,無
臺中市北區賴福里,99,606,507,1013,1340,75.60,黃灑晴,中國國民黨
臺中市北區賴興里,86,665,579,1098,1544,71.11,盧冬松,無
臺中市北區邱厝里,-114,343,457,790,1143,69.12,高敏裕,無
臺中市北區金華里,-59,473,532,864,1161,74.42,蘇福安,無
臺中市北區金龍里,265,684,419,997,1358,73.42,馬國樑,無
臺中市北區錦平里,-87,302,389,679,980,69.29,游金隆,無
臺中市北區錦村里,-79,499,578,1233,1610,76.58,吳榮益,中國國民黨
臺中市北區錦洲里,193,544,351,716,1013,70.68,吳昌隆,無
臺中市北區錦祥里,502,1004,502,1078,1531,70.41,林美玉,無
臺中市北區長青里,604,1028,424,1000,1405,71.17,林裕賜,中國國民黨
臺中市北區頂厝里,79,670,591,901,1232,73.13,呂理宗,無
臺中市北屯區三光里,658,1159,501,907,1181,76.80,林瑞芳,中國國民黨
臺中市北屯區三和里,301,967,666,1136,1509,75.28,許勝雄,無
臺中市北屯區仁和里,782,1426,644,845,1076,78.53,張永漢,無
臺中市北屯區仁愛里,-180,163,343,779,1028,75.78,張耀祖,中國國民黨
臺中市北屯區仁美里,1250,1929,679,998,1340,74.48,朱清華,無
臺中市北屯區北京里,-141,446,587,722,1011,71.41,蘇乙青,無
臺中市北屯區北屯里,-19,520,539,891,1243,71.68,歐真宗,無
臺中市北屯區北興里,113,515,402,629,870,72.30,廖玉森,無
臺中市北屯區同榮里,312,927,615,1140,1489,76.56,王煌照,中國國民黨
臺中市北屯區后庄里,1189,1803,614,898,1239,72.48,張瓊月,中國國民黨
臺中市北屯區和平里,1811,2242,431,1045,1405,74.38,林標權,無
臺中市北屯區四民里,-168,488,656,1109,1418,78.21,江麗慧,中國國民黨
臺中市北屯區大坑里,-182,331,513,675,1024,65.92,曾朝瑝,無
臺中市北屯區大德里,204,786,582,906,1255,72.19,李必勝,中國國民黨
臺中市北屯區平和里,542,965,423,880,1180,74.58,林煜舜,無
臺中市北屯區平安里,513,847,334,817,1109,73.67,吳亞君,無
臺中市北屯區平德里,634,1080,446,942,1283,73.42,歐志隆,無
臺中市北屯區平心里,302,871,569,818,1129,72.45,陳文欽,無
臺中市北屯區平昌里,281,729,448,797,1142,69.79,劉慶雲,中國國民黨
臺中市北屯區平田里,569,946,377,731,1031,70.90,潘玉洪,無
臺中市北屯區平福里,-21,581,602,858,1105,77.65,張振治,無
臺中市北屯區平興里,826,1234,408,983,1408,69.82,黃彰國,無
臺中市北屯區平陽里,243,824,581,794,1087,73.05,張連進,無
臺中市北屯區平順里,86,560,474,799,1063,75.16,賴錫鏗,無
臺中市北屯區廍子里,3891,4548,657,770,1050,73.33,董銘成,無
臺中市北屯區忠平里,75,656,581,944,1283,73.58,許秀蓉,中國國民黨
臺中市北屯區新平里,-20,672,692,1071,1550,69.10,李良仁,中國國民黨
臺中市北屯區東光里,187,741,554,763,1035,73.72,賴文章,中國國民黨
臺中市北屯區東山里,-228,251,479,850,1156,73.53,邱財源,民主進步黨
臺中市北屯區松勇里,199,883,684,913,1181,77.31,王嘉君,中國國民黨
臺中市北屯區松和里,684,1201,517,880,1249,70.46,賴天權,中國國民黨
臺中市北屯區松安里,447,854,407,838,1101,76.11,賴仕翰,無
臺中市北屯區松強里,703,1257,554,920,1262,72.90,魏清鏘,無
臺中市北屯區松竹里,1165,1620,455,860,1169,73.57,簡禎緯,無
臺中市北屯區松茂里,327,889,562,931,1223,76.12,何志恆,無
臺中市北屯區民德里,-188,124,312,677,943,71.79,江承鴻,無
臺中市北屯區民政里,-360,137,497,704,994,70.82,黃明華,無
臺中市北屯區水景里,2093,2512,419,940,1241,75.75,何明坤,無
臺中市北屯區水湳里,568,1096,528,1063,1422,74.75,賴進堂,中國國民黨
臺中市北屯區舊社里,2593,2992,399,1014,1267,80.03,謝秉憲,無
臺中市北屯區軍功里,1739,2342,603,805,1109,72.59,黃銘河,無
臺中市北屯區陳平里,390,893,503,1110,1520,73.03,林家峯,中國國民黨
臺中市南區南和里,711,1323,612,1106,1403,78.83,黃寶蓮,無
臺中市南區南門里,185,572,387,848,1106,76.67,何湞惠,無
臺中市南區和平里,553,833,280,1144,1540,74.29,張敏生,無
臺中市南區國光里,172,554,382,890,1193,74.60,廖胤凱,無
臺中市南區城隍里,156,536,380,816,1104,73.91,林炳儀,無
臺中市南區崇倫里,596,988,392,1057,1374,76.93,曾素貞,民主進步黨
臺中市南區工學里,853,1387,534,1025,1370,74.82,王文明,無
臺中市南區平和里,185,517,332,841,1129,74.49,柯永宏,無
臺中市南區德義里,-6,444,450,1028,1338,76.83,林志昌,無
臺中市南區新榮里,580,894,314,823,1099,74.89,蔡明昌,民主進步黨
臺中市南區樹德里,1124,1753,629,989,1262,78.37,余銘記,無
臺中市南區樹義里,2140,2617,477,902,1250,72.16,莊郁雄,無
臺中市南區永和里,439,849,410,798,1077,74.09,李起綸,無
臺中市南區永興里,1214,1569,355,1110,1499,74.05,陳松鶴,無
臺中市南區江川里,-1,426,427,978,1298,75.35,楊明俊,無
臺中市南區福平里,302,933,631,883,1243,71.04,張啓龍,中國國民黨
臺中市南區福興里,158,571,413,995,1295,76.83,陳友龍,無
臺中市南區福順里,686,1142,456,1092,1429,76.42,鄭正叡,無
臺中市南區積善里,-171,350,521,843,1111,75.88,余惠貞,無
臺中市南區西川里,30,763,733,1090,1431,76.17,葉家宏,無
臺中市南區長春里,-124,240,364,610,871,70.03,林姍汝,無
臺中市南區長榮里,-324,371,695,881,1146,76.88,林政蒼,無
臺中市南屯區三厝里,832,1491,659,984,1288,76.40,黃俊銘,民主進步黨
臺中市南屯區三和里,1081,1671,590,1128,1441,78.28,張家蓉,無
臺中市南屯區三義里,636,1191,555,990,1290,76.74,陳惠鈴,無
臺中市南屯區中和里,-57,683,740,1048,1423,73.65,蔡德勇,無
臺中市南屯區南屯里,969,1502,533,904,1190,75.97,林秋潭,中國國民黨
臺中市南屯區同心里,662,963,301,1098,1462,75.10,蔡保秀,無
臺中市南屯區向心里,245,918,673,1252,1637,76.48,蕭惠丰,無
臺中市南屯區大同里,448,930,482,1026,1379,74.40,游月珠,無
臺中市南屯區大業里,452,1143,691,939,1237,75.91,賴樹杉,無
臺中市南屯區大興里,227,746,519,982,1259,78.00,許鳳凰,無
臺中市南屯區大誠里,140,696,556,876,1125,77.87,王宗裕,無
臺中市南屯區寶山里,619,1077,458,943,1284,73.44,廖振源,無
臺中市南屯區惠中里,746,1450,704,1230,1650,74.55,沈呈融,無
臺中市南屯區文山里,2143,2616,473,929,1320,70.38,何中信,無
臺中市南屯區文心里,227,694,467,905,1203,75.23,王國在,中國國民黨
臺中市南屯區新生里,230,662,432,1256,1650,76.12,盧坤炳,無
臺中市南屯區春安里,-9,718,727,534,710,75.21,閻新懃,無
臺中市南屯區春社里,613,989,376,873,1176,74.23,李志洋,無
臺中市南屯區楓樹里,389,1052,663,977,1223,79.89,陳伯仲,無
臺中市南屯區永定里,484,948,464,875,1193,73.34,賴榮斌,無
臺中市南屯區溝墘里,314,956,642,943,1183,79.71,郭錦興,中國國民黨
臺中市南屯區田心里,720,1245,525,1212,1574,77.00,吳碧珣,無
臺中市南屯區豐樂里,1642,2010,368,1063,1390,76.47,蔡奇洲,無
臺中市南屯區鎮平里,-226,162,388,966,1245,77.59,廖秀麗,無
臺中市南屯區黎明里,288,633,345,693,888,78.04,馬蓮菁,無
臺中市后里區中和里,79,414,335,889,1177,75.53,陳水波,無
臺中市后里區仁里里,-286,149,435,723,982,73.63,鐘基文,無
臺中市后里區公館里,-265,319,584,753,1018,73.97,馮詠淮,無
臺中市后里區厚里里,-301,381,682,716,952,75.21,黃金益,無
臺中市后里區后里里,-3,629,632,850,1121,75.83,楊春明,無
臺中市后里區墩北里,253,605,352,956,1250,76.48,羅金浩,無
臺中市后里區墩南里,62,584,522,899,1179,76.25,陳輝,無
臺中市后里區墩東里,430,811,381,824,1116,73.84,傅鈺婷,無
臺中市后里區墩西里,-228,295,523,644,951,67.72,紀廷芳,無
臺中市后里區太平里,-101,360,461,709,1004,70.62,黃士瑋,無
臺中市后里區廣福里,-296,299,595,614,832,73.80,郭明洲,中國國民黨
臺中市后里區月眉里,-52,326,378,748,993,75.33,吳新春,無
臺中市后里區泰安里,-214,239,453,1025,1382,74.17,謝學和,無
臺中市后里區眉山里,334,618,284,738,1022,72.21,潘錦致,無
臺中市后里區義德里,-261,395,656,937,1336,70.13,謝榮慶,無
臺中市后里區義里里,209,498,289,755,1092,69.14,林東成,無
臺中市后里區聯合里,-96,264,360,522,711,73.42,陳查某,無
臺中市后里區舊社里,3,420,417,868,1196,72.58,林有盛,無
臺中市和平區中坑里,-103,64,167,344,448,76.79,李明毅,無
臺中市和平區南勢里,-152,235,387,645,922,69.96,蔡金火,無
臺中市和平區博愛里,-57,167,224,654,952,68.70,范忠文,無
臺中市和平區天輪里,-86,57,143,326,445,73.26,劉興水,無
臺中市和平區平等里,-211,73,284,79,145,54.48,梁韶陽,無
臺中市和平區梨山里,-2,152,154,202,358,56.42,張守宏,無
臺中市和平區自由里,22,141,119,202,287,70.38,張弘承,無
臺中市和平區達觀里,-25,113,138,547,762,71.78,吳振福,無
臺中市外埔區三崁里,43,301,258,750,1019,73.60,林月草,無
臺中市外埔區中山里,-249,239,488,887,1164,76.20,張素惠,無
臺中市外埔區六分里,-191,414,605,741,997,74.32,劉黃碧霞,無
臺中市外埔區土城里,-180,202,382,593,775,76.52,鄭興川,無
臺中市外埔區大同里,80,851,771,822,1076,76.39,林益年,無
臺中市外埔區大東里,709,1191,482,758,1013,74.83,高芳春,無
臺中市外埔區廍子里,-283,173,456,787,1112,70.77,廖泰祥,無
臺中市外埔區水美里,270,668,398,801,1089,73.55,許蓮美,無
臺中市外埔區永豐里,-340,203,543,767,1057,72.56,洪俊義,無
臺中市外埔區鐵山里,-129,348,477,648,906,71.52,劉圳,無
臺中市外埔區馬鳴里,-544,224,768,953,1314,72.53,顏慶慰,無
臺中市大安區中庄里,-350,415,765,860,1205,71.37,莊明堯,無
臺中市大安區南埔里,-396,142,538,679,987,68.79,林恭,無
臺中市大安區南庄里,-371,160,531,686,960,71.46,陳炳煌,無
臺中市大安區東安里,-537,194,731,899,1173,76.64,黃為德,無
臺中市大安區松雅里,-220,202,422,755,970,77.84,張鐿騰,無
臺中市大安區永安里,109,284,175,881,1239,71.11,卓江山,無
臺中市大安區海墘里,-168,239,407,426,602,70.76,王勝宗,無
臺中市大安區福住里,-236,167,403,730,1038,70.33,吳添福,無
臺中市大安區福興里,-454,187,641,790,1086,72.74,林正岳,無
臺中市大安區西安里,-79,308,387,691,917,75.35,紀木淵,無
臺中市大安區頂安里,-240,130,370,618,850,72.71,陳麗涓,無
臺中市大安區龜壳里,17,237,220,629,831,75.69,洪正義,無
臺中市大甲區中山里,463,908,445,986,1314,75.04,廖嘉佐,中國國民黨
臺中市大甲區南陽里,-336,128,464,570,777,73.36,黃火塗,無
臺中市大甲區大甲里,-371,152,523,697,924,75.43,黃勝裕,無
臺中市大甲區太白里,-255,169,424,844,1155,73.07,游招滿,民主進步黨
臺中市大甲區奉化里,128,401,273,906,1207,75.06,白見發,無
臺中市大甲區孔門里,-106,108,214,466,718,64.90,吳柏坤,無
臺中市大甲區孟春里,-123,630,753,970,1339,72.44,黃湘榕,無
臺中市大甲區岷山里,-6,359,365,708,980,72.24,林清良,無
臺中市大甲區平安里,-251,317,568,712,962,74.01,周寶惜,無
臺中市大甲區幸福里,-49,389,438,753,1093,68.89,林晨彬,無
臺中市大甲區庄美里,-150,367,517,751,998,75.25,魏李嫌,無
臺中市大甲區建興里,-486,211,697,1000,1395,71.68,蔡明河,無
臺中市大甲區德化里,-120,329,449,643,856,75.12,李柄杉,無
臺中市大甲區文曲里,-374,143,517,714,1040,68.65,林寶彩,無
臺中市大甲區文武里,471,981,510,724,971,74.56,葉淑惠,民主進步黨
臺中市大甲區新美里,4,568,564,726,1002,72.46,王生源,無
臺中市大甲區日南里,572,971,399,911,1242,73.35,邱大豪,無
臺中市大甲區朝陽里,-151,218,369,935,1258,74.32,林立偉,無
臺中市大甲區武曲里,-9,356,365,722,945,76.40,蘇月鳳,無
臺中市大甲區武陵里,-307,193,500,832,1124,74.02,方如玉,無
臺中市大甲區江南里,-410,251,661,946,1331,71.07,李文登,無
臺中市大甲區福德里,-452,169,621,755,1056,71.50,莊金波,無
臺中市大甲區義和里,-14,632,646,772,1043,74.02,洪黃素貞,無
臺中市大甲區薰風里,-404,131,535,674,862,78.19,王秋芬,無
臺中市大甲區西岐里,-143,290,433,635,859,73.92,羅永宗,無
臺中市大甲區銅安里,-256,221,477,924,1311,70.48,林玉生,無
臺中市大甲區頂店里,547,825,278,913,1279,71.38,黃安鎮,無
臺中市大甲區順天里,-50,221,271,478,652,73.31,陳威宇,無
臺中市大甲區龍泉里,-167,231,398,483,636,75.94,陳廷旺,無
臺中市大肚區中和里,-180,152,332,639,833,76.71,陳怡均,無
臺中市大肚區大東里,-139,477,616,703,922,76.25,趙政忠,無
臺中市大肚區大肚里,-389,377,766,766,1018,75.25,陳銘潭,無
臺中市大肚區山陽里,-313,202,515,955,1271,75.14,黃冠陽,無
臺中市大肚區成功里,-288,164,452,712,911,78.16,陳新座,無
臺中市大肚區新興里,-159,337,496,1018,1358,74.96,林華龍,無
臺中市大肚區永和里,-330,93,423,586,782,74.94,劉文芳,無
臺中市大肚區永順里,-359,274,633,1273,1650,77.15,陳秋益,無
臺中市大肚區營埔里,-550,253,803,1081,1457,74.19,楊宗吉,無
臺中市大肚區王田里,406,763,357,1147,1544,74.29,孫清海,無
臺中市大肚區瑞井里,555,903,348,1065,1449,73.50,洪忠祿,無
臺中市大肚區磺溪里,-206,297,503,1276,1657,77.01,趙奕忻,無
臺中市大肚區社腳里,-172,412,584,939,1176,79.85,陳榮銀,無
臺中市大肚區福山里,206,528,322,909,1171,77.63,林弘岳,無
臺中市大肚區自強里,58,521,463,854,1211,70.52,林順安,中國國民黨
臺中市大肚區蔗廍里,493,851,358,1107,1539,71.93,林進朝,無
臺中市大肚區頂街里,714,1296,582,1049,1392,75.36,陳武徹,無
臺中市大里區中新里,621,1079,458,927,1320,70.23,廖榮木,無
臺中市大里區仁化里,1145,1548,403,1033,1426,72.44,陳宗興,無
臺中市大里區仁德里,628,1105,477,1156,1578,73.26,林志忠,無
臺中市大里區健民里,483,965,482,1005,1431,70.23,楊進祿,無
臺中市大里區內新里,1364,1576,212,1012,1407,71.93,林溢源,無
臺中市大里區國光里,473,1094,621,1050,1396,75.21,魏益川,無
臺中市大里區塗城里,695,1383,688,1011,1464,69.06,黃仁耀,中國國民黨
臺中市大里區夏田里,-379,148,527,700,912,76.75,曾盛琪,無
臺中市大里區大元里,37,730,693,845,1129,74.84,林瑞興,無
臺中市大里區大明里,295,713,418,1036,1443,71.79,詹武典,無
臺中市大里區大里里,62,633,571,906,1261,71.85,李錫全,無
臺中市大里區新仁里,909,1448,539,993,1377,72.11,洪家裕,無
臺中市大里區新里里,1324,1913,589,953,1358,70.18,何世琦,無
臺中市大里區日新里,27,761,734,1110,1436,77.30,顏子,無
臺中市大里區東昇里,109,558,449,1151,1601,71.89,陳進發,無
臺中市大里區東湖里,1199,1865,666,1300,1853,70.16,何天祿,無
臺中市大里區東興里,808,1194,386,1019,1362,74.82,許榮良,無
臺中市大里區樹王里,104,642,538,857,1127,76.04,陳俞樺,無
臺中市大里區永隆里,1671,2073,402,1244,1631,76.27,林士元,無
臺中市大里區瑞城里,1867,2281,414,1106,1522,72.67,蔡承翰,無
臺中市大里區祥興里,947,1335,388,1281,1721,74.43,黃春海,無
臺中市大里區立仁里,553,984,431,1088,1428,76.19,陳稼松,無
臺中市大里區立德里,1082,1534,452,1138,1560,72.95,江慶賢,無
臺中市大里區西榮里,433,945,512,979,1412,69.33,羅文評,無
臺中市大里區西湖里,-263,443,706,1057,1422,74.33,賴加彬,無
臺中市大里區金城里,1189,1670,481,1157,1663,69.57,潘國琦,中國國民黨
臺中市大里區長榮里,1114,1623,509,1111,1482,74.97,洪資源,中國國民黨
臺中市大雅區三和里,410,1003,593,1002,1301,77.02,廖顯彬,中國國民黨
臺中市大雅區上楓里,489,1274,785,1205,1611,74.80,鄧兆堂,無
臺中市大雅區上雅里,850,1237,387,1117,1500,74.47,陳映辰,無
臺中市大雅區二和里,513,1168,655,1104,1484,74.39,陳明村,無
臺中市大雅區六寶里,618,1013,395,1041,1568,66.39,張嘉榮,無
臺中市大雅區員林里,1322,1830,508,1161,1574,73.76,張本侒,無
臺中市大雅區四德里,133,896,763,1059,1443,73.39,呂啟勳,無
臺中市大雅區大楓里,512,886,374,817,1224,66.75,蔡界地,無
臺中市大雅區大雅里,35,722,687,1115,1471,75.80,李玲珍,無
臺中市大雅區忠義里,-91,504,595,823,1239,66.42,林義木,中國國民黨
臺中市大雅區文雅里,753,1117,364,984,1404,70.09,賴福林,無
臺中市大雅區橫山里,177,827,650,1082,1404,77.07,張聖河,無
臺中市大雅區秀山里,216,574,358,757,1017,74.43,蔡錦瑭,無
臺中市大雅區西寶里,162,825,663,1149,1625,70.71,劉孝民,無
臺中市大雅區雅楓里,124,566,442,870,1161,74.94,張東開,無
臺中市太平區中山里,-194,465,659,1165,1671,69.72,閻泰利,中國國民黨
臺中市太平區中平里,31,656,625,1056,1495,70.64,林碧森,無
臺中市太平區中政里,49,559,510,801,1154,69.41,林宗慶,無
臺中市太平區中興里,36,531,495,747,996,75.00,林阿爐,無
臺中市太平區光明里,18,603,585,895,1269,70.53,胥樹文,中國國民黨
臺中市太平區光華里,318,810,492,1000,1376,72.67,黃鐵騫,無
臺中市太平區光隆里,-187,493,680,1110,1526,72.74,張雅芳,無
臺中市太平區勤益里,16,340,324,730,1041,70.12,馮耀祖,中國國民黨
臺中市太平區坪林里,160,482,322,841,1139,73.84,賴啓誠,中國國民黨
臺中市太平區大興里,15,391,376,1012,1461,69.27,鄭金川,無
臺中市太平區太平里,435,825,390,880,1290,68.22,林龍洲,無
臺中市太平區宜佳里,476,1076,600,1151,1608,71.58,張麗眞,無
臺中市太平區宜昌里,328,797,469,833,1157,72.00,林進發,無
臺中市太平區宜欣里,373,984,611,1293,1735,74.52,楊登圳,中國國民黨
臺中市太平區平安里,-112,352,464,857,1192,71.90,施秀彩,無
臺中市太平區建國里,-239,449,688,877,1304,67.25,江德海,中國國民黨
臺中市太平區建興里,-192,384,576,1000,1511,66.18,胡長志,中國國民黨
臺中市太平區德隆里,448,828,380,816,1164,70.10,吳燕明,無
臺中市太平區成功里,206,684,478,798,1153,69.21,洪大鈞,無
臺中市太平區新光里,696,1404,708,986,1374,71.76,游癸龍,無
臺中市太平區新吉里,693,1182,489,1065,1445,73.70,黃天財,無
臺中市太平區新坪里,1082,1479,397,1194,1731,68.98,紀進豐,無
臺中市太平區新城里,724,1176,452,1109,1581,70.15,胡錩宏,無
臺中市太平區新福里,700,1379,679,1088,1498,72.63,李子濬,無
臺中市太平區新興里,888,1453,565,1227,1641,74.77,李建民,無
臺中市太平區新高里,1402,2048,646,1488,1985,74.96,江姿樺,無
臺中市太平區東和里,-149,457,606,946,1381,68.50,賴來旺,無
臺中市太平區東平里,295,714,419,1022,1476,69.24,温錦昌,無
臺中市太平區東汴里,-439,139,578,764,1125,67.91,呂坤龍,無
臺中市太平區永平里,341,734,393,991,1384,71.60,賴義涼,無
臺中市太平區永成里,856,1273,417,1033,1434,72.04,陳秋蟬,無
臺中市太平區永隆里,-48,405,453,897,1228,73.05,張立緯,無
臺中市太平區福隆里,208,559,351,899,1262,71.24,黃楷能,無
臺中市太平區聖和里,-263,213,476,1057,1503,70.33,劉佳明,無
臺中市太平區興隆里,-133,464,597,1102,1642,67.11,張閔南,無
臺中市太平區豐年里,-14,651,665,1129,1556,72.56,劉盈欣,無
臺中市太平區長億里,809,1188,379,1166,1588,73.43,呂也好,無
臺中市太平區頭汴里,-131,207,338,606,864,70.14,江思涵,無
臺中市太平區黃竹里,-300,72,372,435,600,72.50,林元成,無
臺中市新社區中和里,-283,60,343,406,539,75.32,鄭文章,無
臺中市新社區中正里,-570,218,788,976,1331,73.33,張鳳梅,無
臺中市新社區中興里,-240,55,295,440,584,75.34,李劉秀雲,中國國民黨
臺中市新社區協成里,-149,374,523,701,969,72.34,王再興,無
臺中市新社區大南里,-90,228,318,684,964,70.95,黃逸峯,無
臺中市新社區崑山里,-216,148,364,825,1100,75.00,廖銘洲,無
臺中市新社區復盛里,-191,283,474,624,884,70.59,柯廷蓁,無
臺中市新社區慶西里,-228,108,336,155,213,72.77,蔡嘉宜,無
臺中市新社區新社里,130,507,377,758,1006,75.35,黃正光,無
臺中市新社區月湖里,-456,125,581,693,968,71.59,高清源,無
臺中市新社區東興里,-322,161,483,834,1166,71.53,張文明,無
臺中市新社區永源里,60,413,353,774,1011,76.56,蘇東波,無
臺中市新社區福興里,-1,95,96,603,880,68.52,劉春財,無
臺中市東勢區上城里,-400,139,539,694,922,75.27,張玉雲,無
臺中市東勢區上新里,-229,127,356,700,907,77.18,王綉滿,中國國民黨
臺中市東勢區下城里,-369,93,462,583,810,71.98,劉海湖,無
臺中市東勢區下新里,-59,226,285,536,755,70.99,詹前貴,無
臺中市東勢區中寧里,-253,117,370,568,793,71.63,廖歆,無
臺中市東勢區中嵙里,-88,251,339,615,851,72.27,王鎭樑,無
臺中市東勢區北興里,-250,204,454,949,1377,68.92,李德興,無
臺中市東勢區南平里,-225,245,470,659,894,73.71,黃文茂,無
臺中市東勢區埤頭里,-187,98,285,481,636,75.63,林坤詮,無
臺中市東勢區廣興里,-503,177,680,961,1330,72.26,廖紫台,無
臺中市東勢區延平里,-292,280,572,763,1080,70.65,吳文龍,無
臺中市東勢區慶東里,-23,229,252,690,941,73.33,黃國修,無
臺中市東勢區慶福里,-474,142,616,778,1177,66.10,林金泉,無
臺中市東勢區新盛里,280,741,461,946,1290,73.33,吳進聰,無
臺中市東勢區明正里,-400,155,555,894,1297,68.93,吳萬明,無
臺中市東勢區東安里,-416,130,546,696,962,72.35,楊嘉裕,無
臺中市東勢區東新里,-106,301,407,765,990,77.27,余運來,無
臺中市東勢區泰昌里,4,461,457,811,1118,72.54,徐鎮富,無
臺中市東勢區泰興里,-298,89,387,498,688,72.38,江國豐,無
臺中市東勢區福隆里,146,523,377,868,1187,73.13,林品巧,無
臺中市東勢區粵寧里,-476,273,749,508,679,74.82,詹德旺,無
臺中市東勢區興隆里,-268,146,414,801,1125,71.20,徐錦全,無
臺中市東勢區茂興里,-233,243,476,628,907,69.24,吳仁文,無
臺中市東勢區詒福里,12,207,195,624,843,74.02,郭丞漢,無
臺中市東勢區隆興里,-530,165,695,967,1368,70.69,蘇清泉,無
臺中市東區十甲里,309,856,547,830,1154,71.92,林昑照,無
臺中市東區合作里,132,673,541,1023,1357,75.39,曾建成,中國國民黨
臺中市東區富仁里,321,572,251,821,1188,69.11,司宇辰,無
臺中市東區富台里,-3,234,237,512,724,70.72,石國勳,中國國民黨
臺中市東區干城里,23,370,347,847,1116,75.90,張碧芝,無
臺中市東區振興里,117,437,320,752,1027,73.22,劉作文,無
臺中市東區新庄里,-18,394,412,597,1185,50.38,洪宗毅,無
臺中市東區旱溪里,76,365,289,606,824,73.54,郭松益,無
臺中市東區東信里,1053,1484,431,967,1231,78.55,洪榮吉,無
臺中市東區東勢里,-213,386,599,858,1244,68.97,張財良,中國國民黨
臺中市東區東南里,32,620,588,937,1308,71.64,王瑞發,中國國民黨
臺中市東區東橋里,153,594,441,1008,1319,76.42,何冠緯,無
臺中市東區東興里,33,487,454,1015,1350,75.19,宋茂榮,中國國民黨
臺中市東區東英里,880,1390,510,958,1212,79.04,林德興,無
臺中市東區東門里,1087,1374,287,918,1153,79.62,莊錦聰,無
臺中市東區樂成里,-159,387,546,987,1313,75.17,曾仁杰,無
臺中市東區泉源里,-207,341,548,765,1002,76.35,羅文甫,無
臺中市梧棲區下寮里,-64,322,386,813,1085,74.93,許福順,無
臺中市梧棲區中和里,-253,59,312,349,471,74.10,林淑貞,無
臺中市梧棲區中正里,230,628,398,740,1040,71.15,林祝女,無
臺中市梧棲區南簡里,619,1126,507,986,1355,72.77,蔡佳君,無
臺中市梧棲區大庄里,965,1462,497,796,1054,75.52,楊維智,無
臺中市梧棲區大村里,241,1086,845,1083,1448,74.79,陳昆廷,無
臺中市梧棲區安仁里,-282,120,402,518,728,71.15,薛志富,無
臺中市梧棲區文化里,-506,183,689,832,1109,75.02,蔡傳枝,無
臺中市梧棲區永安里,-242,393,635,979,1386,70.63,王連松,無
臺中市梧棲區永寧里,-307,345,652,770,1057,72.85,李皆得,無
臺中市梧棲區福德里,527,1019,492,908,1248,72.76,紀建豪,無
臺中市梧棲區興農里,-232,476,708,731,1017,71.88,陳起益,無
臺中市梧棲區草湳里,479,1179,700,716,1027,69.72,林槐庭,無
臺中市梧棲區頂寮里,112,752,640,905,1294,69.94,鐘金水,無
臺中市沙鹿區三鹿里,1041,1655,614,984,1340,73.43,顏清通,無
臺中市沙鹿區公明里,416,778,362,960,1318,72.84,蔡水松,無
臺中市沙鹿區六路里,799,1229,430,1067,1421,75.09,陳永祥,無
臺中市沙鹿區北勢里,779,1013,234,715,972,73.56,陳科求,無
臺中市沙鹿區南勢里,304,732,428,556,725,76.69,王愷,無
臺中市沙鹿區埔子里,859,1347,488,1029,1339,76.85,蔡伶青,無
臺中市沙鹿區居仁里,46,218,172,540,712,75.84,黃月兒,無
臺中市沙鹿區斗抵里,570,878,308,993,1276,77.82,王宏書,無
臺中市沙鹿區晉江里,-206,325,531,505,679,74.37,李瑞珍,無
臺中市沙鹿區沙鹿里,-405,99,504,632,847,74.62,蔡曉婷,無
臺中市沙鹿區洛泉里,-103,289,392,602,801,75.16,黃金,無
臺中市沙鹿區清泉里,-152,450,602,977,1272,76.81,蔡國欣,無
臺中市沙鹿區犁分里,-351,204,555,819,1082,75.69,陳文宜,無
臺中市沙鹿區福興里,407,794,387,1103,1405,78.51,蔣木林,無
臺中市沙鹿區竹林里,1148,1413,265,683,941,72.58,陳吉成,無
臺中市沙鹿區美仁里,-193,69,262,342,454,75.33,陳建良,無
臺中市沙鹿區興仁里,130,406,276,597,771,77.43,劉驊慶,無
臺中市沙鹿區興安里,360,654,294,967,1301,74.33,白來清,無
臺中市沙鹿區西勢里,-261,327,588,773,1056,73.20,蔡坤地,無
臺中市沙鹿區鹿寮里,889,1310,421,865,1111,77.86,王榮正,無
臺中市沙鹿區鹿峰里,594,1138,544,972,1344,72.32,白淞元,無
臺中市清水區下湳里,-96,431,527,899,1292,69.58,李王玉蘭,無
臺中市清水區中社里,71,503,432,1151,1550,74.26,王瑜蘭,中國國民黨
臺中市清水區中興里,-224,65,289,297,372,79.84,蔡興達,無
臺中市清水區北寧里,-305,92,397,506,658,76.90,紀文來,中國國民黨
臺中市清水區南寧里,-191,290,481,603,822,73.36,高志勇,無
臺中市清水區南社里,1322,1971,649,909,1225,74.20,崔惠國,無
臺中市清水區吳厝里,-655,222,877,1071,1417,75.58,吳水通,無
臺中市清水區國姓里,-203,262,465,731,1079,67.75,黃秀英,無
臺中市清水區文昌里,-137,90,227,462,611,75.61,楊介猶,無
臺中市清水區東山里,-483,181,664,820,1160,70.69,王偉權,無
臺中市清水區楊厝里,-488,182,670,773,1082,71.44,曾弘利,無
臺中市清水區槺榔里,993,1736,743,992,1426,69.57,洪水家,無
臺中市清水區橋頭里,562,1332,770,915,1275,71.76,林瑶卿,無
臺中市清水區武鹿里,336,576,240,823,1191,69.10,陳志一,無
臺中市清水區海濱里,-303,313,616,775,1043,74.30,陳山林,無
臺中市清水區海風里,-566,250,816,1012,1352,74.85,黃堉睿,無
臺中市清水區清水里,-35,442,477,587,854,68.74,陳安吉,無
臺中市清水區田寮里,-120,372,492,906,1313,69.00,許進興,無
臺中市清水區秀水里,260,774,514,1082,1482,73.01,陳月娟,無
臺中市清水區臨江里,-657,206,863,1055,1444,73.06,洪敏哲,無
臺中市清水區菁埔里,-44,353,397,818,1089,75.11,林子清,無
臺中市清水區裕嘉里,-289,218,507,990,1374,72.05,陳瑞欽,無
臺中市清水區西寧里,-695,227,922,1106,1488,74.33,王慶源,無
臺中市清水區西社里,-17,352,369,1057,1382,76.48,楊茂雄,無
臺中市清水區靈泉里,-368,139,507,674,871,77.38,顏貽松,無
臺中市清水區頂湳里,-350,260,610,592,798,74.19,王景收,無
臺中市清水區高北里,-510,151,661,718,1110,64.68,白銀堂,無
臺中市清水區高南里,-555,179,734,838,1237,67.74,楊忠銘,無
臺中市清水區高東里,-345,188,533,839,1173,71.53,蔡榮聰,無
臺中市清水區高美里,-352,179,531,902,1263,71.42,洪瑞晟,無
臺中市清水區高西里,-582,161,743,854,1230,69.43,洪曜南,無
臺中市清水區鰲峰里,-288,141,429,769,1032,74.52,蔡裕生,無
臺中市潭子區嘉仁里,179,683,504,888,1174,75.64,林瑞文,無
臺中市潭子區大富里,-178,540,718,1177,1521,77.38,林啓彬,無
臺中市潭子區大豐里,727,1198,471,1150,1504,76.46,蕭清柏,無
臺中市潭子區家福里,728,950,222,1099,1395,78.78,鄭朝元,中國國民黨
臺中市潭子區家興里,951,1314,363,963,1346,71.55,莊世雄,無
臺中市潭子區新田里,-556,222,778,1105,1489,74.21,吳政潭,無
臺中市潭子區東寶里,1770,2127,357,1038,1410,73.62,林銘泉,無
臺中市潭子區栗林里,492,859,367,915,1231,74.33,簡順雄,無
臺中市潭子區潭北里,-190,427,617,862,1140,75.61,林俊堂,無
臺中市潭子區潭秀里,-198,219,417,932,1207,77.22,陳健峯,無
臺中市潭子區潭陽里,1590,1897,307,973,1297,75.02,楊仲傑,無
臺中市潭子區甘蔗里,1223,1842,619,1042,1411,73.85,黃正堯,中國國民黨
臺中市潭子區福仁里,1442,1898,456,1103,1470,75.03,游豐瑋,無
臺中市潭子區聚興里,266,623,357,889,1229,72.34,林信士,無
臺中市潭子區頭家東里,447,747,300,916,1270,72.13,劉進福,中國國民黨
臺中市潭子區頭家里,425,1008,583,1147,1514,75.76,黃聖明,中國國民黨
臺中市烏日區三和里,1327,1711,384,1288,1644,78.35,楊添和,無
臺中市烏日區九德里,1835,2161,326,1117,1422,78.55,陳美香,無
臺中市烏日區五光里,-373,289,662,1272,1660,76.63,林榮源,無
臺中市烏日區仁德里,915,1331,416,998,1304,76.53,洪炳煌,中國國民黨
臺中市烏日區光明里,-235,351,586,661,876,75.46,賴信忠,無
臺中市烏日區前竹里,-327,251,578,466,585,79.66,林東潭,無
臺中市烏日區北里里,-565,242,807,1229,1588,77.39,魏周森,無
臺中市烏日區南里里,-520,246,766,1019,1313,77.61,蔡敏陽,無
臺中市烏日區學田里,45,440,395,996,1335,74.61,孫禾昀,無
臺中市烏日區東園里,70,426,356,958,1254,76.40,張有城,無
臺中市烏日區榮泉里,731,1446,715,865,1143,75.68,何聰智,無
臺中市烏日區湖日里,3,488,485,899,1187,75.74,楊來成,無
臺中市烏日區溪埧里,287,729,442,1066,1338,79.67,陳登正,無
臺中市烏日區溪尾里,-206,141,347,598,798,74.94,顏寶玉,無
臺中市烏日區烏日里,1264,1625,361,1187,1440,82.43,陳新安,無
臺中市烏日區螺潭里,-149,366,515,789,1023,77.13,林國貞,無
臺中市石岡區九房里,-452,181,633,878,1178,74.53,張鴻斌,民主進步黨
臺中市石岡區和盛里,-491,169,660,872,1181,73.84,何賴財桂,無
臺中市石岡區土牛里,-247,130,377,696,980,71.02,管德財,無
臺中市石岡區德興里,-302,180,482,957,1334,71.74,劉紀雄,無
臺中市石岡區梅子里,-244,250,494,474,649,73.04,郭光勇,無
臺中市石岡區石岡里,-402,181,583,853,1143,74.63,陸永晟,無
臺中市石岡區萬安里,-245,249,494,1158,1488,77.82,林子晏,無
臺中市石岡區萬興里,-330,219,549,1073,1388,77.31,羅益洲,無
臺中市石岡區金星里,-310,136,446,855,1174,72.83,李淑惠,無
臺中市石岡區龍興里,-309,75,384,442,604,73.18,黃清標,無
臺中市神岡區三角里,-342,443,785,870,1142,76.18,江炳煌,無
臺中市神岡區北庄里,39,446,407,1005,1297,77.49,王秋生,無
臺中市神岡區圳前里,-114,350,464,934,1206,77.45,陳木生,中國國民黨
臺中市神岡區圳堵里,-74,357,431,692,908,76.21,鄭秀燕,無
臺中市神岡區大社里,435,839,404,893,1164,76.72,高元平,無
臺中市神岡區山皮里,-431,156,587,754,981,76.86,陳勝泧,民主進步黨
臺中市神岡區岸裡里,-230,438,668,1104,1429,77.26,謝繼潭,無
臺中市神岡區庄前里,-50,429,479,933,1197,77.94,張鎮正,無
臺中市神岡區庄後里,-13,350,363,857,1136,75.44,林美玲,無
臺中市神岡區新庄里,167,671,504,977,1352,72.26,張育豪,無
臺中市神岡區溪洲里,-275,456,731,1109,1435,77.28,王明洲,無
臺中市神岡區社南里,605,1005,400,1026,1404,73.08,楊春福,民主進步黨
臺中市神岡區社口里,1122,1415,293,954,1296,73.61,陳金地,無
臺中市神岡區神岡里,37,529,492,807,1066,75.70,王百瀛,無
臺中市神岡區神洲里,-136,416,552,887,1168,75.94,陳大燿,無
臺中市神岡區豐洲里,593,1164,571,939,1270,73.94,王文松,無
臺中市西區三民里,-135,256,391,663,1533,43.25,廖吳芬芳,無
臺中市西區中興里,49,533,484,862,1131,76.22,湯鈞任,無
臺中市西區公平里,234,818,584,892,1259,70.85,魏素眞,中國國民黨
臺中市西區公德里,188,743,555,1072,1422,75.39,楊博文,中國國民黨
臺中市西區公正里,638,1147,509,868,1159,74.89,林哲雄,中國國民黨
臺中市西區公民里,417,740,323,772,1054,73.24,林鈞陶,無
臺中市西區公益里,-234,439,673,1042,1384,75.29,劉興峰,無
臺中市西區公舘里,452,901,449,1004,1311,76.58,謝錫宏,無
臺中市西區利民里,-413,204,617,956,1282,74.57,陳敏祥,中國國民黨
臺中市西區双龍里,-14,401,415,905,1260,71.83,林坤泉,中國國民黨
臺中市西區吉龍里,786,1071,285,969,1294,74.88,李國禎,無
臺中市西區和龍里,-29,331,360,910,1258,72.34,孟慶華,無
臺中市西區土庫里,459,857,398,678,887,76.44,粟藍倩,無
臺中市西區大忠里,297,803,506,899,1119,80.34,張智權,無
臺中市西區安龍里,-316,430,746,937,1269,73.84,賴梁松,無
臺中市西區平和里,55,297,242,674,958,70.35,張洪惠雪,中國國民黨
臺中市西區廣民里,-473,195,668,960,1329,72.23,林水順,無
臺中市西區後龍里,205,515,310,762,1022,74.56,郭耀泉,無
臺中市西區忠明里,369,877,508,835,1084,77.03,賴瑞滄,無
臺中市西區忠誠里,361,883,522,993,1414,70.23,趙瑞豐,無
臺中市西區昇平里,237,930,693,1046,1407,74.34,蕭行凱,無
臺中市西區東昇里,-180,347,527,872,1123,77.65,徐耀鍾,無
臺中市西區民生里,-145,272,417,575,778,73.91,黃文濱,中國國民黨
臺中市西區民龍里,213,626,413,761,1015,74.98,吳國楨,中國國民黨
臺中市西區藍興里,225,700,475,1082,1355,79.85,黃富榮,無
臺中市西屯區上安里,643,1016,373,1005,1321,76.08,賴耀熙,無
臺中市西屯區上德里,47,689,642,975,1326,73.53,洪頊晿,無
臺中市西屯區上石里,810,1055,245,941,1291,72.89,馮華昌,中國國民黨
臺中市西屯區何仁里,848,1125,277,998,1380,72.32,蔡翔宇,無
臺中市西屯區何南里,152,731,579,977,1308,74.69,曹豐洋,無
臺中市西屯區何厝里,32,527,495,763,1070,71.31,何劉美玲,無
臺中市西屯區何安里,432,991,559,1086,1493,72.74,何唐文鈴,無
臺中市西屯區何德里,335,676,341,936,1235,75.79,林志雄,無
臺中市西屯區何成里,545,1104,559,1086,1493,72.74,田貴玉,無
臺中市西屯區何明里,10,560,550,917,1143,80.23,趙淑妙,無
臺中市西屯區何源里,562,1178,616,881,1201,73.36,彭琴安,中國國民黨
臺中市西屯區何福里,265,742,477,1062,1412,75.21,何淑玲,民主進步黨
臺中市西屯區協和里,361,849,488,887,1189,74.60,陳靖益,無
臺中市西屯區大河里,159,628,469,947,1224,77.37,陳資源,無
臺中市西屯區大石里,-72,327,399,833,1079,77.20,吳忠華,中國國民黨
臺中市西屯區大福里,-61,517,578,667,984,67.78,高信增,中國國民黨
臺中市西屯區大鵬里,530,786,256,1048,1326,79.03,邱清涼,中國國民黨
臺中市西屯區廣福里,-230,332,562,909,1205,75.44,吳賢龍,無
臺中市西屯區惠來里,2215,2573,358,964,1373,70.21,廖慶麟,無
臺中市西屯區林厝里,149,629,480,903,1199,75.31,余進卿,中國國民黨
臺中市西屯區永安里,2242,2548,306,1084,1414,76.66,張阿淑,中國國民黨
臺中市西屯區港尾里,338,885,547,855,1170,73.08,楊忠義,無
臺中市西屯區潮洋里,470,1107,637,1142,1536,74.35,陳素貞,無
臺中市西屯區福中里,288,588,300,793,1101,72.03,廖阿月,中國國民黨
臺中市西屯區福和里,286,756,470,1111,1481,75.02,林寅利,無
臺中市西屯區福安里,126,625,499,1150,1535,74.92,張清和,無
臺中市西屯區福恩里,659,991,332,777,1038,74.86,陳桂香,中國國民黨
臺中市西屯區福林里,1189,1598,409,958,1307,73.30,林柏翰,無
臺中市西屯區福瑞里,-54,552,606,1049,1475,71.12,林添憶,中國國民黨
臺中市西屯區福聯里,-6,602,608,1128,1707,66.08,馮進通,無
臺中市西屯區福雅里,470,1160,690,1060,1414,74.96,王勝偉,中國國民黨
臺中市西屯區至善里,93,793,700,1052,1402,75.04,鄭文昌,無
臺中市西屯區西墩里,811,1186,375,862,1138,75.75,廖家慧,無
臺中市西屯區西安里,772,1156,384,1006,1372,73.32,徐文電,無
臺中市西屯區西平里,293,828,535,804,1165,69.01,廖建森,中國國民黨
臺中市西屯區逢甲里,132,862,730,1221,1630,74.91,廖婉菁,無
臺中市西屯區逢福里,394,916,522,1108,1443,76.78,張文平,無
臺中市西屯區鵬程里,-95,343,438,922,1257,73.35,陳文聿,中國國民黨
臺中市西屯區龍潭里,-212,172,384,754,1004,75.10,張清文,無
臺中市豐原區三村里,700,1140,440,908,1173,77.41,許全木,無
臺中市豐原區下街里,-65,146,211,570,744,76.61,林貴榮,無
臺中市豐原區中山里,-234,121,355,609,772,78.89,林榮一,無
臺中市豐原區中興里,-304,509,813,980,1380,71.01,魏丞章,無
臺中市豐原區中陽里,459,906,447,1042,1344,77.53,黃英瑜,無
臺中市豐原區北湳里,173,566,393,837,1089,76.86,張靜宜,無
臺中市豐原區北陽里,1880,2309,429,1157,1546,74.84,林昆民,無
臺中市豐原區南嵩里,201,552,351,744,988,75.30,劉玉玲,無
臺中市豐原區南村里,434,988,554,1119,1463,76.49,謝見忠,無
臺中市豐原區南田里,174,544,370,822,1105,74.39,劉醇權,無
臺中市豐原區南陽里,1367,1939,572,924,1306,70.75,楊國勝,無
臺中市豐原區圳寮里,-264,213,477,936,1186,78.92,陳坤湖,無
臺中市豐原區大湳里,-145,429,574,823,1158,71.07,張鳳茹,無
臺中市豐原區富春里,-355,91,446,529,662,79.91,陳麗鳳,無
臺中市豐原區朴子里,84,560,476,808,1075,75.16,陳文啓,無
臺中市豐原區東勢里,-577,189,766,1000,1369,73.05,胡慧玲,無
臺中市豐原區東湳里,188,698,510,1060,1418,74.75,唐志勇,無
臺中市豐原區東陽里,-564,214,778,1171,1508,77.65,張德勲,無
臺中市豐原區民生里,-183,175,358,791,1069,73.99,吳俊德,無
臺中市豐原區田心里,503,1023,520,916,1687,54.30,徐倍基,無
臺中市豐原區社皮里,1169,1778,609,991,1359,72.92,涂力旋,中國國民黨
臺中市豐原區翁子里,-49,585,634,795,1035,76.81,連佳振,無
臺中市豐原區翁明里,68,463,395,847,1092,77.56,高銘傳,無
臺中市豐原區翁社里,-298,326,624,681,920,74.02,吳安修,無
臺中市豐原區葫蘆里,-116,85,201,428,576,74.31,王彥閔,無
臺中市豐原區西勢里,19,360,341,981,1237,79.30,王建清,無
臺中市豐原區西安里,440,863,423,901,1101,81.83,羅茂榮,無
臺中市豐原區西湳里,1375,1778,403,1034,1366,75.70,蔣年峯,無
臺中市豐原區豐原里,-159,349,508,611,917,66.63,洪源隆,無
臺中市豐原區豐圳里,154,593,439,948,1209,78.41,鄭文鑫,無
臺中市豐原區豐榮里,-395,162,557,779,1052,74.05,林金玉,無
臺中市豐原區豐田里,1054,1715,661,1102,1444,76.32,劉瑞銓,中國國民黨
臺中市豐原區豐西里,-104,274,378,634,833,76.11,葉明昌,無
臺中市豐原區鎌村里,136,758,622,1142,1497,76.29,林隆源,無
臺中市豐原區陽明里,80,456,376,1024,1305,78.47,林汶垚,無
臺中市豐原區頂街里,-276,135,411,645,886,72.80,吳令儀,無
臺中市霧峰區丁台里,-104,350,454,854,1087,78.56,洪耀南,無
臺中市霧峰區中正里,98,354,256,887,1097,80.86,林進生,無
臺中市霧峰區五福里,-242,425,667,1011,1308,77.29,陳岳彬,無
臺中市霧峰區六股里,-290,356,646,886,1126,78.69,王原祥,無
臺中市霧峰區北勢里,-273,330,603,769,1015,75.76,洪金生,無
臺中市霧峰區北柳里,217,680,463,965,1272,75.86,吳儒親,無
臺中市霧峰區南勢里,-473,191,664,944,1242,76.01,黃清標,無
臺中市霧峰區南柳里,-28,325,353,759,991,76.59,楊國忠,無
臺中市霧峰區吉峰里,943,1459,516,721,1122,64.26,林政逸,無
臺中市霧峰區四德里,-59,457,516,1002,1370,73.14,紀天富,無
臺中市霧峰區坑口里,208,420,212,769,1031,74.59,王中興,無
臺中市霧峰區峰谷里,-215,171,386,805,1087,74.06,黃錦昌,無
臺中市霧峰區本堂里,611,970,359,801,1068,75.00,林錦池,無
臺中市霧峰區本鄉里,-83,370,453,815,1050,77.62,林揚展,無
臺中市霧峰區桐林里,-132,200,332,925,1179,78.46,林國安,無
臺中市霧峰區甲寅里,418,765,347,821,1122,73.17,李明忠,無
臺中市霧峰區舊正里,-253,312,565,711,940,75.64,張國財,無
臺中市霧峰區萊園里,-237,159,396,761,988,77.02,唐青山,無
臺中市霧峰區萬豐里,-247,342,589,888,1256,70.70,林麗真,無
臺中市霧峰區錦榮里,-429,195,624,927,1240,74.76,張永昇,無
臺中市龍井區三德里,104,495,391,1061,1463,72.52,楊易明,無
臺中市龍井區南寮里,-353,238,591,1222,1498,81.58,林志強,無
臺中市龍井區山腳里,608,1084,476,1057,1462,72.30,陳春雄,無
臺中市龍井區忠和里,427,899,472,917,1166,78.64,林聰海,無
臺中市龍井區新庄里,545,1126,581,1028,1423,72.24,陳進爵,無
臺中市龍井區新東里,286,833,547,791,1105,71.58,劉克俊,無
臺中市龍井區東海里,1089,1568,479,977,1351,72.32,林秋蘭,無
臺中市龍井區田中里,223,744,521,1082,1422,76.09,張文慶,無
臺中市龍井區福田里,-294,142,436,712,1009,70.56,歐錦墩,無
臺中市龍井區竹坑里,-60,612,672,668,910,73.41,許麗珠,無
臺中市龍井區麗水里,-57,360,417,1000,1328,75.30,陳耀墩,無
臺中市龍井區龍崗里,-159,490,649,983,1371,71.70,林朝清,無
臺中市龍井區龍東里,56,531,475,1034,1400,73.86,林金鍊,無
臺中市龍井區龍泉里,1091,1484,393,992,1380,71.88,黃聖龍,無
臺中市龍井區龍津里,499,896,397,1042,1440,72.36,張坤雄,無
臺中市龍井區龍西里,-72,287,359,658,888,74.10,黃碧林,無
