村里,2024-2022,2024民眾黨,2022村里長得票,2024投票數,2024選舉人數,2024投票率,里長姓名,里長政黨
高雄市三民區力行里,-261,109,370,1480,2020,0.7,李水池,中國國民黨
高雄市三民區十全里,-382,190,572,1898,2638,0.7,洪能通,無
高雄市三民區十美里,-168,89,257,1347,1897,0.7,蔡灯能,民主進步黨
高雄市三民區千北里,-393,98,491,1426,1994,0.7,黃林麗香,無
高雄市三民區千歲里,-467,113,580,1495,2101,0.7,許婉羚,無
高雄市三民區千秋里,-138,172,310,2011,2913,0.7,蔡文和,無
高雄市三民區博惠里,-6,382,388,3446,4797,0.7,洪耀斌,無
高雄市三民區博愛里,-482,137,619,1504,2133,0.7,鍾秋美,無
高雄市三民區同德里,-119,264,383,2608,3558,0.7,陳清源,無
高雄市三民區安吉里,98,608,510,4162,5906,0.7,王明文,無
高雄市三民區安和里,-397,300,697,2532,3456,0.7,傅秋陽,民主進步黨
高雄市三民區安宜里,-319,334,653,2947,3977,0.7,周黃俊宇,無
高雄市三民區安寧里,-213,169,382,2077,3119,0.7,郭海定,民主進步黨
高雄市三民區安康里,-151,150,301,1824,2793,0.7,孫聖雄,無
高雄市三民區安東里,-123,391,514,2978,4006,0.7,林添祥,無
高雄市三民區安泰里,-36,403,439,3258,4567,0.7,謝明學,無
高雄市三民區安生里,-274,211,485,1900,2641,0.7,余許淑女,無
高雄市三民區安發里,134,486,352,3889,5551,0.7,許峻溢,無
高雄市三民區安邦里,43,452,409,3368,4620,0.7,黃崑山,無
高雄市三民區寶中里,-79,320,399,2897,4100,0.7,任憲慶,中國國民黨
高雄市三民區寶國里,712,1028,316,6238,8694,0.7,黃兆華,民主進步黨
高雄市三民區寶安里,444,831,387,5698,8096,0.7,黃柏澤,中國國民黨
高雄市三民區寶德里,145,582,437,4369,6127,0.7,潘進派,民主進步黨
高雄市三民區寶慶里,-39,307,346,2789,3949,0.7,陳昱昌,無
高雄市三民區寶業里,146,832,686,5184,7050,0.7,林煥然,民主進步黨
高雄市三民區寶民里,-230,402,632,3081,4359,0.7,陳詩椿,無
高雄市三民區寶泰里,48,359,311,2763,3967,0.7,黃仲霖,民主進步黨
高雄市三民區寶獅里,-94,449,543,3415,4731,0.7,林昆明,無
高雄市三民區寶玉里,729,1121,392,6588,9097,0.7,黃昱椉,無
高雄市三民區寶珠里,-9,592,601,4461,7964,0.6,陳榮增,民主進步黨
高雄市三民區寶盛里,170,603,433,4364,6032,0.7,任天霸,無
高雄市三民區寶興里,379,804,425,5564,7746,0.7,許慶銘,無
高雄市三民區寶華里,-230,403,633,3138,4348,0.7,李清樺,無
高雄市三民區寶龍里,-136,442,578,3807,5292,0.7,黃美琴,無
高雄市三民區川東里,-505,106,611,1506,2187,0.7,李明海,無
高雄市三民區建東里,-302,123,425,1426,2166,0.7,陳建藏,無
高雄市三民區德仁里,-240,200,440,1976,2792,0.7,袁碧嬌,民主進步黨
高雄市三民區德北里,-6,265,271,2261,3174,0.7,李仁祥,無
高雄市三民區德智里,-65,203,268,2219,3014,0.7,李明同,民主進步黨
高雄市三民區德東里,-344,83,427,1257,1755,0.7,許玉秀,無
高雄市三民區德行里,-371,93,464,1478,2051,0.7,郭麗香,無
高雄市三民區德西里,-366,365,731,2107,2988,0.7,林財旺,無
高雄市三民區本上里,124,620,496,4226,5775,0.7,詹鶴,無
高雄市三民區本元里,306,644,338,4624,6277,0.7,吳朝桂,民主進步黨
高雄市三民區本和里,319,926,607,5742,7870,0.7,陳文旗,無
高雄市三民區本安里,288,588,300,4066,5553,0.7,王金堂,民主進步黨
高雄市三民區本揚里,557,939,382,6212,8394,0.7,蘇永樹,無
高雄市三民區本文里,-153,138,291,1447,1989,0.7,郭和成,民主進步黨
高雄市三民區本武里,4,197,193,2142,2983,0.7,吳阿吉,民主進步黨
高雄市三民區本館里,417,1043,626,6642,9170,0.7,簡明鎮,無
高雄市三民區正興里,1324,1670,346,9135,13066,0.7,沈秀玲,民主進步黨
高雄市三民區正順里,10,476,466,3581,5037,0.7,黃冠惠,無
高雄市三民區民享里,-91,175,266,2076,2856,0.7,吳慶東,無
高雄市三民區港新里,-132,157,289,1771,2424,0.7,蘇麗玉,無
高雄市三民區港東里,-554,116,670,1597,2339,0.7,張士賢,無
高雄市三民區港西里,-277,65,342,1202,1749,0.7,閩興傳,民主進步黨
高雄市三民區灣中里,111,608,497,4208,6130,0.7,楊宏明,無
高雄市三民區灣利里,-324,271,595,2842,3901,0.7,郭峻毅,民主進步黨
高雄市三民區灣勝里,-255,161,416,1994,2746,0.7,陳金櫃,民主進步黨
高雄市三民區灣子里,110,456,346,3403,4789,0.7,方相茗,無
高雄市三民區灣復里,-30,425,455,3122,4368,0.7,吳國清,無
高雄市三民區灣愛里,-67,302,369,2576,3794,0.7,邱清勳,無
高雄市三民區灣成里,-144,393,537,2618,3719,0.7,黃文良,無
高雄市三民區灣興里,-119,205,324,2037,2747,0.7,張文青,無
高雄市三民區灣華里,-46,330,376,2480,3467,0.7,高素女,中國國民黨
高雄市三民區立德里,-298,121,419,1507,2146,0.7,林平長,中國國民黨
高雄市三民區立業里,-335,91,426,1312,1884,0.7,陳姵羽,無
高雄市三民區立誠里,-236,60,296,1187,1674,0.7,陳永進,中國國民黨
高雄市三民區精華里,-504,141,645,1762,2460,0.7,何佳憲,民主進步黨
高雄市三民區興德里,-71,238,309,2068,2903,0.7,陳國欽,無
高雄市三民區裕民里,-259,164,423,1575,2247,0.7,陳水榮,無
高雄市三民區豐裕里,-134,228,362,2270,3270,0.7,謝錫元,無
高雄市三民區達仁里,-480,167,647,1693,2360,0.7,邱添富,民主進步黨
高雄市三民區達勇里,-190,95,285,1319,1898,0.7,李少緯,無
高雄市三民區達德里,-462,135,597,1616,2229,0.7,陳國枝,無
高雄市三民區達明里,-629,143,772,1763,2492,0.7,張簡王玉珠,民主進步黨
高雄市三民區長明里,-340,107,447,1392,2002,0.7,林練丁,無
高雄市三民區鳳北里,-501,129,630,1622,2254,0.7,鄭健村,無
高雄市三民區鳳南里,-315,114,429,1400,1984,0.7,王進祿,無
高雄市三民區鼎中里,-69,484,553,3703,5066,0.7,李水發,無
高雄市三民區鼎力里,-33,519,552,3766,5245,0.7,沈巽榮,無
高雄市三民區鼎強里,-85,307,392,2811,3970,0.7,林國石,無
高雄市三民區鼎泰里,2072,2799,727,15933,21926,0.7,張吉雄,無
高雄市三民區鼎盛里,594,991,397,6129,8640,0.7,謝有清,民主進步黨
高雄市三民區鼎西里,374,935,561,5866,8281,0.7,姚素眞,民主進步黨
高雄市三民區鼎金里,-103,454,557,3614,5214,0.7,高豐麟,無
高雄市仁武區中華里,-564,182,746,1079,1563,0.7,林志榮,民主進步黨
高雄市仁武區五和里,514,772,258,3772,5351,0.7,林雅婷,民主進步黨
高雄市仁武區仁和里,90,438,348,2811,3843,0.7,鄭諭澤,無
高雄市仁武區仁慈里,44,400,356,2681,3523,0.8,洪月琴,民主進步黨
高雄市仁武區仁武里,53,677,624,3625,5377,0.7,劉俊彥,無
高雄市仁武區仁福里,-391,64,455,557,825,0.7,朱興,無
高雄市仁武區八卦里,2391,2929,538,13803,19278,0.7,謝秋江,無
高雄市仁武區大灣里,171,665,494,3482,4828,0.7,謝瑋原,民主進步黨
高雄市仁武區後安里,-293,266,559,1784,2473,0.7,黃榮輝,無
高雄市仁武區文武里,846,1236,390,6633,9199,0.7,蔡進德,無
高雄市仁武區灣內里,554,1154,600,5917,8230,0.7,鄭文輝,民主進步黨
高雄市仁武區烏林里,-95,412,507,2321,3556,0.7,林文斌,民主進步黨
高雄市仁武區竹後里,-203,217,420,1589,2196,0.7,黃常志,無
高雄市仁武區考潭里,-112,282,394,1866,2548,0.7,蔡德明,無
高雄市仁武區赤山里,596,1030,434,5145,6978,0.7,謝青原,民主進步黨
高雄市仁武區高楠里,-133,486,619,2217,3004,0.7,李志能,無
高雄市內門區三平里,-266,56,322,389,604,0.6,洪生業,無
高雄市內門區中埔里,-226,39,265,363,514,0.7,謝清雄,無
高雄市內門區光興里,-215,71,286,431,616,0.7,王士訓,無
高雄市內門區內南里,-137,34,171,249,381,0.7,沈芳昌,無
高雄市內門區內東里,-302,46,348,508,713,0.7,陳明章,無
高雄市內門區內興里,-215,29,244,352,572,0.6,力永信,無
高雄市內門區內豊里,-526,85,611,765,1112,0.7,龔飛盛,無
高雄市內門區內門里,-461,79,540,625,896,0.7,蔡瓊鳳,無
高雄市內門區木柵里,-270,40,310,370,556,0.7,机素勤,無
高雄市內門區東埔里,-170,43,213,302,458,0.7,張錦泉,無
高雄市內門區永吉里,-144,23,167,248,404,0.6,李永坤,無
高雄市內門區永富里,-410,70,480,602,926,0.7,蒙勝南,無
高雄市內門區永興里,-121,28,149,240,370,0.6,陳順良,無
高雄市內門區溝坪里,-292,66,358,531,877,0.6,謝振明,無
高雄市內門區瑞山里,-139,21,160,206,302,0.7,黄淑玲,無
高雄市內門區石坑里,-179,43,222,312,477,0.7,劉文斌,無
高雄市內門區觀亭里,-247,158,405,1102,1588,0.7,許志芳,無
高雄市內門區金竹里,-268,36,304,401,603,0.7,林熾杉,無
高雄市六龜區中興里,-222,118,340,843,1354,0.6,陳信景,無
高雄市六龜區六龜里,-243,54,297,468,894,0.5,邱國輝,無
高雄市六龜區大津里,-84,30,114,210,291,0.7,林文察,無
高雄市六龜區寶來里,-260,50,310,478,823,0.6,沈振揚,無
高雄市六龜區文武里,-366,92,458,746,1321,0.6,鍾達煌,無
高雄市六龜區新威里,-211,52,263,430,675,0.6,邱民棟,無
高雄市六龜區新寮里,-289,38,327,401,596,0.7,朱玉雲,無
高雄市六龜區新發里,-340,52,392,470,880,0.5,劉俊麟,無
高雄市六龜區新興里,-260,51,311,381,626,0.6,邱瑞明,無
高雄市六龜區義寶里,-237,69,306,593,954,0.6,鍾啟鴻,無
高雄市六龜區興龍里,-310,34,344,407,742,0.5,張榮華,無
高雄市六龜區荖濃里,-256,90,346,708,1305,0.5,陳俊福,無
高雄市前金區三川里,-106,136,242,1307,1765,0.7,莊晉勲,無
高雄市前金區北金里,-178,86,264,1209,1687,0.7,林福枝,無
高雄市前金區博孝里,-222,104,326,1346,1868,0.7,方文杰,民主進步黨
高雄市前金區國民里,-192,94,286,1267,1799,0.7,謝明致,無
高雄市前金區後金里,-226,80,306,1091,1502,0.7,施孟均,無
高雄市前金區復元里,-374,93,467,1368,1898,0.7,黃千豪,無
高雄市前金區文東里,-265,135,400,1468,1994,0.7,黃崑光,無
高雄市前金區文西里,-321,113,434,1325,1836,0.7,賴勇村,無
高雄市前金區新生里,-92,451,543,3193,4412,0.7,康文展,無
高雄市前金區東金里,-389,82,471,1291,1825,0.7,謝仲箎,無
高雄市前金區林投里,-194,91,285,1278,1956,0.7,李明峰,無
高雄市前金區榮復里,-396,103,499,1396,1895,0.7,顏炳豪,無
高雄市前金區民生里,-181,6,187,652,909,0.7,黃博群,無
高雄市前金區社東里,-161,139,300,1616,2287,0.7,黃玉英,無
高雄市前金區社西里,-359,154,513,1469,2013,0.7,薛寶琴,無
高雄市前金區草江里,-357,178,535,1585,2225,0.7,陳振琦,無
高雄市前金區長城里,-310,118,428,1544,2198,0.7,李林春蘭,無
高雄市前金區長生里,-276,167,443,1809,2521,0.7,陳宗佐,無
高雄市前金區長興里,-427,154,581,1478,2085,0.7,白宗正,無
高雄市前金區青山里,-55,214,269,1968,2786,0.7,江武吉,無
高雄市前鎮區仁愛里,-369,133,502,1447,2032,0.7,楊朝雄,民主進步黨
高雄市前鎮區信德里,-331,224,555,2600,3707,0.7,李竣帆,無
高雄市前鎮區信義里,-486,130,616,2061,2908,0.7,魏伯曆,民主進步黨
高雄市前鎮區前鎮里,-321,127,448,2048,2840,0.7,許澤能,無
高雄市前鎮區平昌里,-225,62,287,949,1425,0.7,高琅璋,民主進步黨
高雄市前鎮區平等里,-219,190,409,1919,3680,0.5,施長欽,民主進步黨
高雄市前鎮區建隆里,-301,142,443,2082,2938,0.7,林得祿,中國國民黨
高雄市前鎮區復國里,-334,272,606,2806,3880,0.7,呂建霖,民主進步黨
高雄市前鎮區德昌里,-97,184,281,2336,3337,0.7,李正義,無
高雄市前鎮區忠孝里,41,423,382,3377,4676,0.7,陳宜汝,無
高雄市前鎮區忠純里,175,580,405,4894,6716,0.7,艾台民,中國國民黨
高雄市前鎮區忠誠里,-271,202,473,2477,3443,0.7,吳安美,中國國民黨
高雄市前鎮區振興里,-146,304,450,2828,3944,0.7,鍾明憲,無
高雄市前鎮區明孝里,-56,176,232,1722,2422,0.7,林浤澤,無
高雄市前鎮區明正里,290,590,300,4007,5590,0.7,王春茂,民主進步黨
高雄市前鎮區明禮里,-599,162,761,1580,2282,0.7,莊志明,民主進步黨
高雄市前鎮區明義里,-161,236,397,2134,2939,0.7,翁碩聰,無
高雄市前鎮區明道里,-393,90,483,1272,1820,0.7,王進亨,民主進步黨
高雄市前鎮區民權里,-95,471,566,3976,5343,0.7,吳政昇,無
高雄市前鎮區瑞北里,-205,367,572,3204,4521,0.7,陳眞玟,民主進步黨
高雄市前鎮區瑞南里,97,549,452,4153,5756,0.7,張木春,民主進步黨
高雄市前鎮區瑞和里,-164,184,348,2283,3165,0.7,陳文人,民主進步黨
高雄市前鎮區瑞崗里,-189,273,462,2761,3802,0.7,洪金山,民主進步黨
高雄市前鎮區瑞平里,42,415,373,3467,4659,0.7,陳柏村,無
高雄市前鎮區瑞文里,-126,274,400,2629,3702,0.7,邱吉弘,無
高雄市前鎮區瑞昌里,70,387,317,3162,4393,0.7,陳裕達,無
高雄市前鎮區瑞東里,-220,254,474,2529,3583,0.7,許振稽,民主進步黨
高雄市前鎮區瑞祥里,236,566,330,4054,5636,0.7,陳紫鳳,無
高雄市前鎮區瑞竹里,-59,390,449,2498,3428,0.7,許益彰,無
高雄市前鎮區瑞興里,-214,245,459,2746,3820,0.7,陳俊源,民主進步黨
高雄市前鎮區瑞華里,-175,510,685,4079,5598,0.7,蘇榮隆,無
高雄市前鎮區瑞西里,-199,251,450,2749,3859,0.7,蘇悦敏,民主進步黨
高雄市前鎮區瑞誠里,-114,329,443,2792,3872,0.7,林雪娥,無
高雄市前鎮區瑞豐里,5,334,329,2840,3927,0.7,王森騰,民主進步黨
高雄市前鎮區瑞隆里,-106,385,491,3324,4661,0.7,楊家鴻,無
高雄市前鎮區盛興里,-141,277,418,2783,4031,0.7,鍾鳳美,無
高雄市前鎮區盛豐里,-320,318,638,3061,4348,0.7,王志濱,無
高雄市前鎮區竹中里,33,392,359,3404,4672,0.7,莊茂榮,無
高雄市前鎮區竹內里,-307,169,476,2059,2884,0.7,蘇慶忠,無
高雄市前鎮區竹北里,60,349,289,2801,3866,0.7,孫偉光,無
高雄市前鎮區竹南里,634,969,335,5726,7900,0.7,張銓聖,無
高雄市前鎮區竹東里,-218,229,447,2399,3410,0.7,李春桂,無
高雄市前鎮區竹西里,-142,491,633,3868,5268,0.7,林金良,無
高雄市前鎮區興中里,10,314,304,2949,4274,0.7,狄金山,中國國民黨
高雄市前鎮區興仁里,-283,71,354,1623,2259,0.7,張秋敏,無
高雄市前鎮區興化里,-284,72,356,1599,2249,0.7,朱蘇來蔭,無
高雄市前鎮區興東里,116,716,600,4903,6838,0.7,陳建銘,無
高雄市前鎮區興邦里,-285,215,500,2320,3223,0.7,薛文龍,無
高雄市前鎮區良和里,-269,328,597,3120,4288,0.7,陳瑞銓,中國國民黨
高雄市前鎮區草衙里,440,984,544,6106,8923,0.7,李忠正,無
高雄市前鎮區西山里,-30,339,369,3381,4713,0.7,陳天香,無
高雄市前鎮區西甲里,-59,210,269,2577,3608,0.7,潘石誠,民主進步黨
高雄市前鎮區鎮中里,-352,99,451,1708,2412,0.7,湯淑貞,無
高雄市前鎮區鎮北里,-487,118,605,1928,2697,0.7,許昭福,無
高雄市前鎮區鎮昌里,-201,218,419,2514,3472,0.7,涂明鏡,無
高雄市前鎮區鎮東里,-272,182,454,2368,3192,0.7,蔡川士,無
高雄市前鎮區鎮榮里,-315,203,518,2469,3529,0.7,黃士誠,民主進步黨
高雄市前鎮區鎮海里,97,480,383,3862,5417,0.7,蔡葉珍妮,民主進步黨
高雄市前鎮區鎮陽里,-307,102,409,1797,2531,0.7,鄭蔡秀燕,無
高雄市大寮區三隆里,191,534,343,3262,4558,0.7,蕭國欽,民主進步黨
高雄市大寮區上寮里,2,402,400,2599,3667,0.7,洪巧璇,無
高雄市大寮區中庄里,1189,1407,218,7481,10626,0.7,林烔彬,無
高雄市大寮區中興里,227,593,366,4320,6354,0.7,曾幸福,中國國民黨
高雄市大寮區內坑里,473,639,166,3679,5793,0.6,俞金富,無
高雄市大寮區前庄里,-82,255,337,1623,2229,0.7,陳金晚,中國國民黨
高雄市大寮區大寮里,468,742,274,4476,6657,0.7,蕭清翔,無
高雄市大寮區山頂里,488,936,448,5051,7246,0.7,簡子銘,中國國民黨
高雄市大寮區後庄里,556,980,424,5425,7588,0.7,鄭德文,無
高雄市大寮區忠義里,-85,119,204,1220,1802,0.7,邴健鵬,中國國民黨
高雄市大寮區拷潭里,-174,135,309,925,1318,0.7,董鳳松,民主進步黨
高雄市大寮區新厝里,-55,175,230,1111,1614,0.7,張簡龍星,無
高雄市大寮區昭明里,45,436,391,2541,3722,0.7,張簡助昇,無
高雄市大寮區會社里,195,647,452,3881,6057,0.6,吳銀國,無
高雄市大寮區會結里,-150,115,265,1061,1570,0.7,蔡金獅,中國國民黨
高雄市大寮區永芳里,336,811,475,4662,6674,0.7,簡基成,無
高雄市大寮區江山里,-220,166,386,1309,1788,0.7,許世川,無
高雄市大寮區溪寮里,-125,223,348,1798,2423,0.7,王基安,無
高雄市大寮區潮寮里,-97,358,455,2611,3722,0.7,徐新生,無
高雄市大寮區琉球里,358,713,355,3629,5017,0.7,郭秀品,無
高雄市大寮區義仁里,-271,157,428,1195,1746,0.7,許明得,無
高雄市大寮區義和里,-355,248,603,1591,2156,0.7,劉志陽,無
高雄市大寮區翁園里,165,506,341,2900,3906,0.7,蔡順豐,無
高雄市大寮區過溪里,-111,316,427,1713,2439,0.7,陳秀英,無
高雄市大樹區三和里,-245,163,408,1575,2331,0.7,黃重信,無
高雄市大樹區久堂里,-154,484,638,2838,3988,0.7,張勝鋒,中國國民黨
高雄市大樹區九曲里,77,623,546,3463,5106,0.7,潘德勝,中國國民黨
高雄市大樹區井腳里,-71,141,212,1051,1433,0.7,黃沼人,無
高雄市大樹區和山里,-382,90,472,663,957,0.7,吳順治,無
高雄市大樹區大坑里,-465,66,531,920,1362,0.7,吳進雄,無
高雄市大樹區大樹里,-11,339,350,2602,3670,0.7,梁源泰,無
高雄市大樹區姑山里,-293,93,386,691,952,0.7,王莊素真,無
高雄市大樹區小坪里,-408,130,538,892,1252,0.7,郭秀密,無
高雄市大樹區檨腳里,-66,258,324,2323,3310,0.7,吳文雄,無
高雄市大樹區水安里,-131,261,392,1656,2307,0.7,林正道,無
高雄市大樹區水寮里,-374,217,591,1566,2115,0.7,史榮瑞,無
高雄市大樹區溪埔里,-107,140,247,999,1414,0.7,張耀珍,無
高雄市大樹區竹寮里,-347,331,678,1845,2591,0.7,鄭榕華,無
高雄市大樹區統嶺里,-262,42,304,438,626,0.7,許瑞楠,無
高雄市大樹區興山里,-353,138,491,1538,2198,0.7,尹平成,無
高雄市大樹區興田里,-240,133,373,1298,1828,0.7,曾金益,中國國民黨
高雄市大樹區龍目里,-230,154,384,1157,1677,0.7,陳榮清,無
高雄市大社區三奶里,35,297,262,1869,2597,0.7,許丁春,無
高雄市大社區中里里,-45,375,420,2220,3143,0.7,李旭仁,無
高雄市大社區保安里,-41,434,475,2215,3075,0.7,林義萬,民主進步黨
高雄市大社區保社里,118,447,329,2313,3242,0.7,許清泉,民主進步黨
高雄市大社區嘉誠里,-331,89,420,576,855,0.7,侯景耀,無
高雄市大社區大社里,424,590,166,3351,4821,0.7,林英陸,民主進步黨
高雄市大社區神農里,290,634,344,3402,4814,0.7,葉秀英,無
高雄市大社區翠屏里,-116,173,289,1162,1587,0.7,匡淑芳,無
高雄市大社區觀音里,375,668,293,3784,5257,0.7,陳竑憲,無
高雄市小港區三苓里,-132,320,452,2919,4214,0.7,郭冠霖,無
高雄市小港區中厝里,38,440,402,3326,5024,0.7,方蒼賢,無
高雄市小港區二苓里,71,388,317,3441,5057,0.7,馮見仁,無
高雄市小港區六苓里,-270,191,461,2045,2893,0.7,陳美秀,無
高雄市小港區合作里,-230,325,555,2861,4149,0.7,蘇麗美,民主進步黨
高雄市小港區坪頂里,324,763,439,5007,7558,0.7,梁憲宗,無
高雄市小港區大坪里,-258,378,636,2930,4396,0.7,梁正義,無
高雄市小港區大苓里,-172,294,466,2748,3952,0.7,歐世緯,無
高雄市小港區孔宅里,178,494,316,3533,5187,0.7,吳蘆恩,無
高雄市小港區宏亮里,-164,388,552,3163,4612,0.7,宋震寶,無
高雄市小港區小港里,-255,148,403,1885,2747,0.7,洪世春,無
高雄市小港區山明里,1150,1509,359,8519,12195,0.7,陳阿子,無
高雄市小港區山東里,67,360,293,2834,4113,0.7,楊坤止,無
高雄市小港區店鎮里,86,616,530,4809,7028,0.7,楊文良,無
高雄市小港區廈莊里,346,622,276,3856,5700,0.7,李茂群,無
高雄市小港區松山里,-201,395,596,3255,4641,0.7,王美華,無
高雄市小港區松金里,-285,262,547,1933,2769,0.7,沈添福,無
高雄市小港區桂林里,557,1034,477,6258,9003,0.7,侯原庭,無
高雄市小港區正苓里,-56,463,519,3642,5351,0.7,吳惠加,無
高雄市小港區泰山里,-153,393,546,3131,4409,0.7,吳莧山,無
高雄市小港區港南里,-35,398,433,3016,4692,0.6,王秋宏,無
高雄市小港區港口里,-85,356,441,3213,4535,0.7,劉峰吉,無
高雄市小港區港后里,-298,310,608,2865,4000,0.7,柯文世,民主進步黨
高雄市小港區港墘里,-471,216,687,2195,3148,0.7,吳文德,無
高雄市小港區港明里,-298,355,653,3030,4463,0.7,李文正,無
高雄市小港區港正里,-334,312,646,2775,3937,0.7,方林秀娥,無
高雄市小港區港興里,-185,293,478,2688,3782,0.7,歐慧玲,民主進步黨
高雄市小港區濟南里,110,478,368,3675,5201,0.7,薛審,無
高雄市小港區青島里,-465,139,604,1710,2417,0.7,戴又媛,中國國民黨
高雄市小港區順苓里,196,568,372,3948,5820,0.7,呂在和,無
高雄市小港區高松里,44,550,506,3906,5836,0.7,梁志安,無
高雄市小港區鳳宮里,-174,358,532,2792,4147,0.7,曾清全,無
高雄市小港區鳳林里,-213,302,515,2799,4059,0.7,許再生,民主進步黨
高雄市小港區鳳森里,-123,245,368,2237,3258,0.7,陳信雄,無
高雄市小港區鳳源里,-223,302,525,2362,3568,0.7,張宇讚,無
高雄市小港區鳳興里,-293,311,604,2404,3535,0.7,洪富賢,無
高雄市小港區鳳鳴里,-383,349,732,2766,4120,0.7,李月雲,無
高雄市小港區龍鳳里,-279,333,612,2753,4091,0.7,黃文裕,無
高雄市岡山區三和里,-307,88,395,614,838,0.7,陳泰龍,無
高雄市岡山區仁壽里,-66,365,431,2333,3182,0.7,劉永裕,無
高雄市岡山區仁義里,-337,178,515,1375,1772,0.8,顏茂吉,無
高雄市岡山區信義里,14,251,237,1122,1584,0.7,石秀霞,無
高雄市岡山區前峰里,-370,369,739,1940,2733,0.7,蔡佩玲,無
高雄市岡山區劉厝里,-366,163,529,1040,1362,0.8,劉慶煌,民主進步黨
高雄市岡山區協和里,-188,464,652,2511,3421,0.7,呂煌龍,無
高雄市岡山區協榮里,-81,256,337,1470,2022,0.7,蔡麗琴,無
高雄市岡山區台上里,293,816,523,4152,5779,0.7,李金本,無
高雄市岡山區和平里,-76,77,153,336,424,0.8,葉春蘭,無
高雄市岡山區嘉峰里,75,201,126,1231,1694,0.7,高昭南,無
高雄市岡山區嘉興里,-26,368,394,2363,3202,0.7,蔡宜眞,無
高雄市岡山區壽天里,-173,407,580,2293,3089,0.7,莊証州,無
高雄市岡山區壽峰里,-346,296,642,1548,2145,0.7,李美麗,無
高雄市岡山區大莊里,-254,99,353,691,953,0.7,佘能文,無
高雄市岡山區大遼里,-447,166,613,1017,1353,0.8,蔡錫琛,無
高雄市岡山區岡山里,176,535,359,2805,4259,0.7,劉天賦,無
高雄市岡山區平安里,-191,162,353,1434,1951,0.7,劉登榮,無
高雄市岡山區後協里,251,635,384,3840,5319,0.7,李再富,無
高雄市岡山區後紅里,26,579,553,2943,4080,0.7,韓嘉嘉,無
高雄市岡山區忠孝里,174,300,126,1965,2728,0.7,江國華,中國國民黨
高雄市岡山區本洲里,-49,206,255,1148,1609,0.7,施清德,無
高雄市岡山區潭底里,-372,71,443,562,760,0.7,陳勝傑,無
高雄市岡山區灣裡里,-191,226,417,1319,1798,0.7,林仁傑,無
高雄市岡山區為隨里,-112,181,293,1436,1913,0.8,蔡正旭,無
高雄市岡山區白米里,22,281,259,1489,2004,0.7,曾詠妮,無
高雄市岡山區石潭里,-345,208,553,1392,1789,0.8,廖壹正,無
高雄市岡山區碧紅里,197,503,306,2677,3735,0.7,李有財,無
高雄市岡山區福興里,-373,139,512,801,1029,0.8,何進柱,無
高雄市岡山區程香里,269,529,260,2902,3939,0.7,李州正,無
高雄市岡山區竹圍里,579,1015,436,4846,6685,0.7,何榮裕,無
高雄市岡山區維仁里,-256,47,303,675,926,0.7,戴清福,無
高雄市岡山區華崗里,-273,175,448,1166,1492,0.8,杜光達,無
高雄市左營區中北里,-312,43,355,852,1209,0.7,謝瑞真,無
高雄市左營區中南里,-214,35,249,765,1126,0.7,蔣金守,無
高雄市左營區光輝里,-69,278,347,2099,2953,0.7,傅琪隆,中國國民黨
高雄市左營區合群里,-209,251,460,2192,3010,0.7,倪同慧,中國國民黨
高雄市左營區城南里,-197,40,237,755,1109,0.7,謝金得,無
高雄市左營區埤北里,-212,105,317,1241,1823,0.7,李復慶,無
高雄市左營區埤東里,-314,71,385,1063,1514,0.7,鄒秀華,中國國民黨
高雄市左營區埤西里,-321,72,393,1019,1469,0.7,余清榮,無
高雄市左營區尾北里,-263,371,634,2645,3719,0.7,柯錦德,中國國民黨
高雄市左營區尾南里,-302,66,368,911,1321,0.7,余建明,無
高雄市左營區尾西里,-382,98,480,1142,1584,0.7,郭錦彬,無
高雄市左營區屏山里,-363,118,481,1391,2051,0.7,吳榮秀,中國國民黨
高雄市左營區崇實里,-113,491,604,2764,3815,0.7,吳武雄,無
高雄市左營區廍北里,-107,44,151,739,1047,0.7,薛朝文,無
高雄市左營區廍南里,-231,45,276,834,1202,0.7,陳美惠,無
高雄市左營區廟北里,-243,66,309,1013,1451,0.7,蘇進雄,無
高雄市左營區廟東里,-363,53,416,1010,1431,0.7,謝惠娟,無
高雄市左營區新上里,2840,3310,470,19160,26333,0.7,王櫻樺,中國國民黨
高雄市左營區新下里,1273,1921,648,11033,15242,0.7,黃慶德,中國國民黨
高雄市左營區新中里,-307,428,735,3476,4815,0.7,黃昱誌,無
高雄市左營區新光里,1240,1809,569,10735,14870,0.7,黃麗純,中國國民黨
高雄市左營區明建里,-143,156,299,1006,1392,0.7,顏靜玉,無
高雄市左營區果峰里,-560,125,685,1431,2084,0.7,曾瑞水,中國國民黨
高雄市左營區果惠里,-501,129,630,1416,2014,0.7,鄭夙雅,無
高雄市左營區果貿里,-199,265,464,2265,3228,0.7,韓得平,中國國民黨
高雄市左營區永清里,-57,171,228,930,1408,0.7,郭鎮國,中國國民黨
高雄市左營區海勝里,-71,519,590,4295,5966,0.7,梁西榮,中國國民黨
高雄市左營區祥和里,-155,12,167,443,643,0.7,劉德文,中國國民黨
高雄市左營區福山里,4972,5276,304,24912,35248,0.7,葉德龍,中國國民黨
高雄市左營區聖南里,-261,53,314,795,1147,0.7,陳勇利,無
高雄市左營區聖后里,-273,73,346,971,1348,0.7,裴天成,無
高雄市左營區聖西里,-144,3,147,447,666,0.7,黃山本,無
高雄市左營區自助里,151,414,263,1792,2592,0.7,劉淯騰,民主進步黨
高雄市左營區莒光里,-316,149,465,1512,2263,0.7,柯麗枝,無
高雄市左營區菜公里,3612,4098,486,21435,29776,0.7,王振華,中國國民黨
高雄市左營區路東里,-293,60,353,936,1312,0.7,黃秀綢,無
高雄市左營區進學里,-154,132,286,1511,3203,0.5,曹順雄,無
高雄市左營區頂北里,-166,48,214,824,1164,0.7,詹正國,無
高雄市左營區頂西里,-179,78,257,1079,1506,0.7,方秀娟,民主進步黨
高雄市彌陀區光和里,-624,125,749,882,1206,0.7,林清火,無
高雄市彌陀區南寮里,-101,226,327,1441,2032,0.7,吳宏桂,無
高雄市彌陀區彌仁里,-205,35,240,350,503,0.7,梁天賞,無
高雄市彌陀區彌壽里,-367,79,446,576,749,0.8,吳義雄,無
高雄市彌陀區彌陀里,-122,212,334,1236,1666,0.7,林煌陸,無
高雄市彌陀區彌靖里,-171,178,349,1281,1774,0.7,吳志強,無
高雄市彌陀區文安里,-254,157,411,1119,1615,0.7,李泰山,無
高雄市彌陀區海尾里,-257,79,336,558,799,0.7,蘇政峯,無
高雄市彌陀區漯底里,-549,124,673,812,1093,0.7,孫萬賜,無
高雄市彌陀區舊港里,-175,174,349,1114,1501,0.7,李明山,無
高雄市彌陀區過港里,-428,105,533,619,883,0.7,張金長,無
高雄市彌陀區鹽埕里,-111,240,351,1451,1950,0.7,李允條,無
高雄市新興區中東里,-334,254,588,2301,3490,0.7,林明雄,無
高雄市新興區仁聲里,-310,117,427,1296,1836,0.7,蕭育霞,無
高雄市新興區光耀里,-59,259,318,2158,2954,0.7,吳秀鈴,民主進步黨
高雄市新興區南港里,-314,179,493,2027,2673,0.8,陳福明,民主進步黨
高雄市新興區大明里,-391,92,483,1361,1840,0.7,徐慶宗,民主進步黨
高雄市新興區建興里,-275,106,381,1230,1731,0.7,薛富升,民主進步黨
高雄市新興區建華里,-299,94,393,1216,1665,0.7,吳文欽,無
高雄市新興區德政里,-278,74,352,1080,1445,0.7,謝國男,無
高雄市新興區德望里,-191,205,396,1898,2614,0.7,林郭麗玉,無
高雄市新興區德生里,-250,361,611,2628,3590,0.7,吳三雄,民主進步黨
高雄市新興區愛平里,-308,133,441,1312,1775,0.7,高文龍,無
高雄市新興區成功里,-315,167,482,1593,2151,0.7,童健良,中國國民黨
高雄市新興區振成里,-206,99,305,1319,1827,0.7,陳敏夫,無
高雄市新興區振華里,-311,103,414,1348,1838,0.7,吳劍生,中國國民黨
高雄市新興區文昌里,33,361,328,2707,3670,0.7,劉育洋,中國國民黨
高雄市新興區新江里,-403,112,515,1330,1872,0.7,王金龍,無
高雄市新興區明莊里,-266,66,332,1080,1503,0.7,莊其章,無
高雄市新興區東坡里,-369,106,475,1460,1970,0.7,楊福順,民主進步黨
高雄市新興區榮治里,-259,78,337,1120,1510,0.7,許淑芬,無
高雄市新興區正氣里,-520,139,659,1565,2118,0.7,沈玉玲,無
高雄市新興區永寧里,-288,170,458,1601,2204,0.7,施澤民,民主進步黨
高雄市新興區浩然里,-246,194,440,1852,2550,0.7,張榮源,中國國民黨
高雄市新興區漢民里,-166,82,248,1143,1555,0.7,李賢宗,無
高雄市新興區玉衡里,-257,63,320,1100,1498,0.7,蔡瑞彬,無
高雄市新興區秋山里,-341,102,443,1284,1821,0.7,許吳瑞珍,無
高雄市新興區興昌里,-247,108,355,1259,1700,0.7,黃少嫻,無
高雄市新興區華聲里,-314,97,411,1262,1724,0.7,林禮志,無
高雄市新興區蕉園里,-162,84,246,1148,1534,0.7,鄭凱隆,無
高雄市新興區長驛里,-284,97,381,1239,1736,0.7,葉智陽,無
高雄市新興區開平里,-157,358,515,3034,4043,0.8,陳朝居,無
高雄市新興區順昌里,-32,270,302,2181,2943,0.7,林朱堂,無
高雄市新興區黎明里,-273,71,344,1194,1638,0.7,許耀科,民主進步黨
高雄市旗山區三協里,-247,269,516,1510,2158,0.7,劉文寶,無
高雄市旗山區上洲里,-400,113,513,1177,1726,0.7,柯瑞斌,無
高雄市旗山區中寮里,-97,11,108,124,176,0.7,洪萬祥,無
高雄市旗山區中正里,3,131,128,889,1380,0.6,郭舜明,無
高雄市旗山區中洲里,-360,13,373,526,771,0.7,羅昱晴,無
高雄市旗山區南勝里,-279,151,430,1363,1997,0.7,廖宗吉,無
高雄市旗山區南洲里,-367,118,485,1360,1980,0.7,黃吉祥,無
高雄市旗山區圓富里,-56,184,240,1130,1735,0.7,歐忠更,無
高雄市旗山區大山里,-283,129,412,1343,1958,0.7,柯旗旺,無
高雄市旗山區大德里,-203,265,468,1544,2205,0.7,曾慶義,無
高雄市旗山區大林里,-80,100,180,808,1271,0.6,莊柏松,無
高雄市旗山區太平里,-127,223,350,1513,2132,0.7,鄭明成,無
高雄市旗山區廣福里,-115,60,175,401,597,0.7,陳俊吉,無
高雄市旗山區新光里,-341,63,404,526,731,0.7,陳峯翔,無
高雄市旗山區東平里,-247,186,433,1337,1857,0.7,石正忠,無
高雄市旗山區東昌里,-417,97,514,662,960,0.7,邱清郎,無
高雄市旗山區永和里,62,341,279,2083,3090,0.7,周銹玉,無
高雄市旗山區湄洲里,-98,165,263,986,1486,0.7,陳聖允,民主進步黨
高雄市旗山區瑞吉里,-195,196,391,1310,1879,0.7,游俊樺,無
高雄市旗山區竹峰里,-61,168,229,1024,1452,0.7,郭信東,無
高雄市旗山區鯤洲里,-262,65,327,1046,1469,0.7,柯文化,民主進步黨
高雄市旗津區上竹里,-132,278,410,2692,4094,0.7,陳仲智,無
高雄市旗津區中洲里,-61,157,218,2110,3204,0.7,郭美伶,無
高雄市旗津區中興里,-192,259,451,2618,3872,0.7,郭茂盛,無
高雄市旗津區中華里,-372,144,516,1946,2908,0.7,徐漢仁,無
高雄市旗津區北汕里,-111,273,384,2554,3988,0.6,林秀英,無
高雄市旗津區南汕里,-245,203,448,2207,3452,0.6,蔡明議,無
高雄市旗津區安順里,-191,93,284,1486,2312,0.6,莊武益,無
高雄市旗津區實踐里,-182,176,358,1826,2873,0.6,楊台生,無
高雄市旗津區復興里,-539,130,669,1813,2821,0.6,張順皇,無
高雄市旗津區慈愛里,-278,207,485,2283,3614,0.6,夏啓峯,無
高雄市旗津區振興里,-604,158,762,1950,2939,0.7,黃見益,無
高雄市旗津區旗下里,-291,124,415,1706,2598,0.7,杜勝輝,無
高雄市旗津區永安里,-334,112,446,1606,2475,0.6,黃修和,無
高雄市杉林區上平里,-61,98,159,879,1467,0.6,張福松,無
高雄市杉林區大愛里,-139,107,246,1057,1944,0.5,陳木源,無
高雄市杉林區新庄里,-176,96,272,862,1403,0.6,陳勤招,無
高雄市杉林區月眉里,-66,156,222,1466,2553,0.6,官梅英,無
高雄市杉林區月美里,-360,83,443,751,1171,0.6,劉曉君,無
高雄市杉林區木梓里,-300,33,333,368,640,0.6,林同德,無
高雄市杉林區杉林里,-262,35,297,319,555,0.6,陳明昌,無
高雄市杉林區集來里,-323,70,393,676,1178,0.6,楊正雄,無
高雄市林園區中厝里,-148,301,449,1955,2888,0.7,劉誌華,中國國民黨
高雄市林園區中汕里,-148,183,331,1399,2119,0.7,黃國發,無
高雄市林園區中芸里,-70,162,232,1196,1686,0.7,謝樹來,無
高雄市林園區中門里,-332,270,602,1660,2445,0.7,蘇信成,無
高雄市林園區五福里,-265,306,571,1602,2524,0.6,洪月珍,無
高雄市林園區仁愛里,-354,313,667,2091,2874,0.7,呂繼承,無
高雄市林園區北汕里,-252,148,400,969,1505,0.6,謝宿惠,無
高雄市林園區廣應里,-118,383,501,2364,3357,0.7,陳玫玲,無
高雄市林園區文賢里,-275,305,580,1685,2345,0.7,黃三源,無
高雄市林園區東林里,-108,312,420,1916,2849,0.7,盧盈叡,無
高雄市林園區東汕里,-323,110,433,988,1526,0.6,王福成,中國國民黨
高雄市林園區林內里,-64,222,286,1307,1915,0.7,黃清景,無
高雄市林園區林園里,-111,327,438,2070,2923,0.7,黃盟松,無
高雄市林園區林家里,-341,191,532,1597,2298,0.7,林明田,無
高雄市林園區港嘴里,-897,159,1056,1139,1646,0.7,蔡明興,無
高雄市林園區港埔里,-179,210,389,1222,1722,0.7,吳石南,無
高雄市林園區溪州里,-186,522,708,2774,4110,0.7,黃國輝,無
高雄市林園區潭頭里,-384,290,674,1777,2616,0.7,劉建德,無
高雄市林園區王公里,-126,455,581,2734,3972,0.7,洪進財,無
高雄市林園區西汕里,-328,32,360,453,702,0.6,邱鐘城,無
高雄市林園區西溪里,-326,339,665,2256,3304,0.7,李文通,無
高雄市林園區頂厝里,-82,528,610,3080,4544,0.7,陳碧對,無
高雄市林園區鳳芸里,-213,157,370,1237,1695,0.7,王泰山,無
高雄市林園區龔厝里,-391,146,537,1373,1915,0.7,龔芳生,無
高雄市桃源區勤和里,-67,37,104,516,948,0.5,曾江清水,無
高雄市桃源區寶山里,-132,59,191,645,1022,0.6,陳燕霜,無
高雄市桃源區建山里,-208,35,243,385,580,0.7,陳建億,無
高雄市桃源區復興里,-66,27,93,171,281,0.6,江孫財,無
高雄市桃源區拉芙蘭里,-80,31,111,525,967,0.5,謝貴奇,無
高雄市桃源區桃源里,-521,16,537,387,739,0.5,高慕源,無
高雄市桃源區梅山里,-116,18,134,182,263,0.7,顏忠義,無
高雄市桃源區高中里,-274,47,321,377,648,0.6,胡益明,無
高雄市梓官區中崙里,-379,121,500,817,1078,0.8,歐樹發,無
高雄市梓官區信蚵里,-250,273,523,1719,2462,0.7,曾盈豐,無
高雄市梓官區典寶里,-145,330,475,2104,2913,0.7,洪文清,無
高雄市梓官區同安里,-264,197,461,1589,2193,0.7,蔣榮三,無
高雄市梓官區大舍里,8,347,339,2574,3593,0.7,歐淼宗,無
高雄市梓官區智蚵里,74,362,288,2630,3735,0.7,鄭柏政,無
高雄市梓官區梓信里,-91,237,328,1514,2034,0.7,蘇上火,無
高雄市梓官區梓和里,-264,217,481,1629,2130,0.8,姜志豪,無
高雄市梓官區梓平里,-276,172,448,1084,1406,0.8,黃常吉,無
高雄市梓官區梓義里,-60,237,297,1453,2086,0.7,余煊昱,無
高雄市梓官區禮蚵里,-211,150,361,1390,1981,0.7,蔡添寳,無
高雄市梓官區茄苳里,-163,253,416,1525,2165,0.7,劉和村,無
高雄市梓官區赤崁里,-169,173,342,1251,1777,0.7,蔡良鑑,中國國民黨
高雄市梓官區赤東里,-47,224,271,1565,2152,0.7,郭錦成,無
高雄市梓官區赤西里,-357,71,428,532,760,0.7,劉英凱,無
高雄市楠梓區中和里,513,918,405,4491,6437,0.7,楊亷政,無
高雄市楠梓區中興里,-523,365,888,2586,3650,0.7,黃朝吉,無
高雄市楠梓區中陽里,-104,437,541,2997,4942,0.6,李添發,無
高雄市楠梓區久昌里,115,370,255,2741,4039,0.7,辜清桐,無
高雄市楠梓區五常里,428,886,458,4910,7900,0.6,曾榮璋,無
高雄市楠梓區享平里,-16,408,424,2844,4775,0.6,陳顯能,無
高雄市楠梓區仁昌里,211,757,546,4406,6351,0.7,王永坤,中國國民黨
高雄市楠梓區加昌里,654,1050,396,6394,9204,0.7,劉秀英,無
高雄市楠梓區和昌里,-102,193,295,2236,3224,0.7,周海玲,無
高雄市楠梓區國昌里,-35,289,324,2542,3629,0.7,王晟境,無
高雄市楠梓區大昌里,-150,239,389,2236,3297,0.7,戴嘉育,中國國民黨
高雄市楠梓區宏南里,-78,86,164,1427,1992,0.7,張夢麒,無
高雄市楠梓區宏昌里,46,398,352,3080,4421,0.7,劉秀桃,無
高雄市楠梓區宏榮里,-230,333,563,2682,3704,0.7,陳宏榮,中國國民黨
高雄市楠梓區宏毅里,-335,252,587,2410,3292,0.7,馮靖絨,無
高雄市楠梓區廣昌里,-142,292,434,2881,4120,0.7,蔡文東,無
高雄市楠梓區建昌里,-235,287,522,2565,3748,0.7,曾讚義,中國國民黨
高雄市楠梓區惠楠里,-75,285,360,2122,3740,0.6,張珮榕,無
高雄市楠梓區惠民里,383,660,277,3876,6116,0.6,張淑分,無
高雄市楠梓區惠豐里,240,656,416,3974,6249,0.6,黃意玲,無
高雄市楠梓區慶昌里,-65,326,391,3065,4302,0.7,陳玉梅,中國國民黨
高雄市楠梓區東寧里,200,800,600,4027,6256,0.6,蘇吳錦秀,無
高雄市楠梓區泰昌里,-312,143,455,1797,2662,0.7,鄭嘉平,無
高雄市楠梓區清豐里,2774,3183,409,16310,23311,0.7,戴佑東,無
高雄市楠梓區玉屏里,-151,228,379,2434,3283,0.7,洪千雅,無
高雄市楠梓區瑞屏里,-184,401,585,3256,4615,0.7,郭進和,無
高雄市楠梓區盛昌里,358,693,335,4850,6707,0.7,杜炎明,無
高雄市楠梓區福昌里,-392,231,623,2385,3326,0.7,張育綺,無
高雄市楠梓區秀昌里,-44,230,274,2312,3293,0.7,張明全,中國國民黨
高雄市楠梓區稔田里,-190,176,366,2065,2820,0.7,陳瑞輅,無
高雄市楠梓區翠屏里,1823,2239,416,11590,16857,0.7,吳永晨,無
高雄市楠梓區興昌里,244,552,308,4002,5612,0.7,謝騏襄,無
高雄市楠梓區藍田里,1253,1605,352,7033,9617,0.7,謝坤易,民主進步黨
高雄市楠梓區裕昌里,347,658,311,4254,6008,0.7,郭明勲,無
高雄市楠梓區金田里,176,606,430,3871,5383,0.7,邱世宗,無
高雄市楠梓區錦屏里,-162,200,362,2342,3183,0.7,蔡甲庚,無
高雄市楠梓區隆昌里,91,300,209,2481,3575,0.7,蔡淑貞,中國國民黨
高雄市橋頭區三德里,-223,70,293,585,756,0.8,劉崇凱,無
高雄市橋頭區中崎里,-297,70,367,469,627,0.7,蘇招治,無
高雄市橋頭區仕和里,-139,453,592,2735,3546,0.8,朱高成,無
高雄市橋頭區仕豐里,-131,361,492,1986,2583,0.8,周才淵,民主進步黨
高雄市橋頭區仕隆里,-159,228,387,1625,2155,0.8,馬兆賢,無
高雄市橋頭區德松里,-12,199,211,1118,1444,0.8,何東喜,民主進步黨
高雄市橋頭區新莊里,942,1187,245,4315,5880,0.7,朱正清,無
高雄市橋頭區東林里,-334,261,595,1634,2172,0.8,陸見青,無
高雄市橋頭區橋南里,-422,168,590,1486,1937,0.8,蘇道明,無
高雄市橋頭區橋頭里,-148,208,356,1504,1995,0.8,余美蓮,無
高雄市橋頭區甲北里,-66,340,406,2058,2881,0.7,李林足素,無
高雄市橋頭區甲南里,-380,271,651,1748,2354,0.7,方明賢,無
高雄市橋頭區白樹里,181,412,231,2341,3173,0.7,吳安祥,無
高雄市橋頭區筆秀里,-146,159,305,1102,1452,0.8,李庭珮,無
高雄市橋頭區芋寮里,-199,132,331,869,1137,0.8,傅壽勝,無
高雄市橋頭區西林里,-321,128,449,1009,1306,0.8,吳建豐,無
高雄市橋頭區頂鹽里,-375,218,593,1776,2386,0.7,顏家進,無
高雄市永安區保寧里,-24,373,397,1822,2548,0.7,陳文印,無
高雄市永安區新港里,29,308,279,2166,3096,0.7,蘇月鳳,無
高雄市永安區永安里,-201,136,337,1119,1587,0.7,林水雹,無
高雄市永安區永華里,-168,205,373,1306,1813,0.7,林明春,無
高雄市永安區維新里,96,458,362,2350,3310,0.7,蔣福山,無
高雄市永安區鹽田里,-161,33,194,278,401,0.7,柯男烈,無
高雄市湖內區中賢里,-87,308,395,2313,3324,0.7,王阮寶雲,無
高雄市湖內區公舘里,-46,327,373,1618,2206,0.7,林蘇麗雲,無
高雄市湖內區劉家里,-189,135,324,1384,1967,0.7,劉宏添,無
高雄市湖內區大湖里,168,447,279,2672,3697,0.7,洪添謀,無
高雄市湖內區太爺里,-235,82,317,561,746,0.8,蘇宗傑,無
高雄市湖內區忠興里,-232,125,357,1243,1791,0.7,邱韋能,無
高雄市湖內區文賢里,-322,71,393,895,1203,0.7,林金坤,無
高雄市湖內區海埔里,-83,210,293,1195,1694,0.7,杜丙戍,無
高雄市湖內區海山里,-511,47,558,734,1037,0.7,劉寶霞,無
高雄市湖內區湖內里,91,530,439,2662,3735,0.7,林志聰,無
高雄市湖內區湖東里,57,347,290,1813,2683,0.7,黃太平,無
高雄市湖內區田尾里,-347,167,514,1358,1857,0.7,謝秋影,無
高雄市湖內區葉厝里,-39,320,359,1872,2608,0.7,葉進昌,無
高雄市湖內區逸賢里,-440,71,511,767,1105,0.7,林秀卿,無
高雄市燕巢區南燕里,6,468,462,2616,3841,0.7,龔榮源,無
高雄市燕巢區安招里,308,361,53,2335,3234,0.7,黃清吉,中國國民黨
高雄市燕巢區尖山里,-455,93,548,767,1105,0.7,何旭信,無
高雄市燕巢區東燕里,-268,265,533,1625,2252,0.7,吳振武,無
高雄市燕巢區橫山里,-122,185,307,1207,1782,0.7,陳隆盛,無
高雄市燕巢區深水里,-206,206,412,1548,2332,0.7,林明雄,無
高雄市燕巢區瓊林里,-265,263,528,1488,2022,0.7,張舜傑,無
高雄市燕巢區西燕里,-119,431,550,2299,3210,0.7,李秀英,無
高雄市燕巢區角宿里,-89,352,441,1989,2657,0.7,莊璨隆,無
高雄市燕巢區金山里,-123,41,164,299,425,0.7,林順輔,無
高雄市燕巢區鳳雄里,-424,247,671,1639,2367,0.7,陳明發,無
高雄市田寮區七星里,-274,38,312,395,585,0.7,呂革明,無
高雄市田寮區三和里,-158,24,182,188,318,0.6,林正春,無
高雄市田寮區南安里,-82,71,153,615,943,0.7,葉正諒,無
高雄市田寮區古亭里,-184,23,207,305,454,0.7,許英豪,無
高雄市田寮區大同里,-159,24,183,217,351,0.6,王榮華,無
高雄市田寮區崇德里,-384,105,489,640,885,0.7,陳金城,無
高雄市田寮區新興里,-199,91,290,796,1120,0.7,何百農,無
高雄市田寮區田寮里,-179,11,190,223,343,0.7,連于萱,無
高雄市田寮區西德里,-355,57,412,485,729,0.7,黃萬春,無
高雄市田寮區鹿埔里,-165,17,182,242,342,0.7,楊美芬,無
高雄市甲仙區和安里,-292,43,335,399,639,0.6,李新福,中國國民黨
高雄市甲仙區大田里,-210,109,319,842,1461,0.6,張琪,無
高雄市甲仙區寶隆里,-300,34,334,370,616,0.6,連英朱,無
高雄市甲仙區小林里,-173,36,209,281,488,0.6,潘世彬,無
高雄市甲仙區東安里,-123,48,171,225,420,0.5,游新儀,中國國民黨
高雄市甲仙區西安里,-436,67,503,570,826,0.7,范姮枝,中國國民黨
高雄市甲仙區關山里,-280,29,309,373,560,0.7,林欣郿,無
高雄市美濃區中圳里,-144,205,349,1374,2010,0.7,黃其添,無
高雄市美濃區中壇里,-212,146,358,1260,1912,0.7,楊秋田,無
高雄市美濃區合和里,-122,171,293,1475,2305,0.6,林作松,無
高雄市美濃區吉和里,-151,144,295,912,1306,0.7,黃文梅,無
高雄市美濃區吉東里,-181,166,347,1130,1693,0.7,黃新華,無
高雄市美濃區吉洋里,-156,140,296,1154,1743,0.7,曾順昌,無
高雄市美濃區廣德里,-262,154,416,1509,2315,0.7,黃沛文,無
高雄市美濃區廣林里,-191,101,292,863,1365,0.6,傅兆鎮,無
高雄市美濃區德興里,-248,135,383,970,1392,0.7,黃建雄,無
高雄市美濃區東門里,-184,120,304,1187,1866,0.6,羅文俊,無
高雄市美濃區泰安里,-100,192,292,1039,1515,0.7,邱國維,無
高雄市美濃區清水里,-174,145,319,1111,1623,0.7,張金發,無
高雄市美濃區瀰濃里,-29,202,231,1410,2180,0.6,林仁興,無
高雄市美濃區獅山里,-331,187,518,1591,2363,0.7,鍾明福,無
高雄市美濃區祿興里,-162,307,469,2315,3451,0.7,劉昭宏,無
高雄市美濃區福安里,49,207,158,1616,2459,0.7,鍾銘安,無
高雄市美濃區興隆里,-355,45,400,716,1085,0.7,黃耀榮,無
高雄市美濃區龍山里,-390,160,550,1326,2015,0.7,温源興,無
高雄市美濃區龍肚里,-169,90,259,893,1323,0.7,邱連發,無
高雄市苓雅區中正里,-80,347,427,2480,3354,0.7,胡維成,中國國民黨
高雄市苓雅區五權里,-126,248,374,2253,3011,0.7,陳玉環,無
高雄市苓雅區五福里,-63,347,410,3111,4324,0.7,邱瑞祥,民主進步黨
高雄市苓雅區人和里,-218,175,393,1657,2363,0.7,林志田,民主進步黨
高雄市苓雅區仁政里,-511,125,636,1398,1926,0.7,黃裕庭,無
高雄市苓雅區光華里,-297,62,359,982,1393,0.7,吳照鉠,民主進步黨
高雄市苓雅區凱旋里,-285,253,538,2016,2767,0.7,錢雲徽,中國國民黨
高雄市苓雅區博仁里,-239,64,303,963,1360,0.7,陳奇伯,中國國民黨
高雄市苓雅區同慶里,-196,269,465,1992,2703,0.7,高文明,無
高雄市苓雅區和煦里,-216,227,443,1878,2560,0.7,莊財通,無
高雄市苓雅區城北里,-20,192,212,1626,2268,0.7,王宏嘉,無
高雄市苓雅區城東里,-65,221,286,1763,2523,0.7,史妮可,無
高雄市苓雅區城西里,-248,2,250,518,742,0.7,朱育賢,無
高雄市苓雅區奏捷里,-147,183,330,1806,2469,0.7,林豐富,民主進步黨
高雄市苓雅區安祥里,-88,321,409,2590,3550,0.7,董輝章,中國國民黨
高雄市苓雅區尚義里,-190,167,357,1620,2230,0.7,曾蔡玉燕,中國國民黨
高雄市苓雅區廣澤里,-145,181,326,1727,2362,0.7,沈秀美,無
高雄市苓雅區建軍里,-170,141,311,1407,1963,0.7,黄錫聰,無
高雄市苓雅區意誠里,-17,388,405,2861,4375,0.7,蕭長保,中國國民黨
高雄市苓雅區文昌里,-25,384,409,3140,4366,0.7,林博文,民主進步黨
高雄市苓雅區日中里,-20,220,240,1992,2723,0.7,許愛珠,無
高雄市苓雅區普天里,114,413,299,2911,3966,0.7,李文豪,無
高雄市苓雅區普照里,22,298,276,2646,3627,0.7,蔡政宏,無
高雄市苓雅區晴朗里,101,251,150,1877,3366,0.6,孫永吉,無
高雄市苓雅區朝陽里,-22,147,169,1690,2356,0.7,丁文瑞,無
高雄市苓雅區林中里,-92,282,374,2379,3364,0.7,杜佳福,無
高雄市苓雅區林南里,-142,273,415,2437,3393,0.7,黃旭煌,無
高雄市苓雅區林圍里,-49,291,340,2147,2871,0.7,羅莉萍,中國國民黨
高雄市苓雅區林安里,-131,198,329,1591,2205,0.7,張列綱,無
高雄市苓雅區林富里,-176,295,471,2155,2891,0.7,林進安,無
高雄市苓雅區林德里,-159,211,370,1730,2403,0.7,翁正財,無
高雄市苓雅區林榮里,-23,485,508,3131,4356,0.7,王文祿,無
高雄市苓雅區林泉里,-153,205,358,1817,2471,0.7,翁烔訓,中國國民黨
高雄市苓雅區林興里,-155,120,275,1326,1903,0.7,黃培裕,民主進步黨
高雄市苓雅區林華里,22,258,236,2357,3204,0.7,張家偉,民主進步黨
高雄市苓雅區林西里,-127,147,274,1543,2198,0.7,方琪麟,中國國民黨
高雄市苓雅區林貴里,-48,211,259,1785,2429,0.7,黃清溪,無
高雄市苓雅區林靖里,-65,173,238,1815,2499,0.7,蔡温怡,無
高雄市苓雅區正仁里,-45,321,366,2396,3339,0.7,黃敏捷,無
高雄市苓雅區正大里,139,595,456,4094,5811,0.7,陳錦宏,無
高雄市苓雅區正心里,13,394,381,3062,4223,0.7,陳顏秋萍,中國國民黨
高雄市苓雅區正文里,-249,324,573,2493,3392,0.7,莊文忠,無
高雄市苓雅區正義里,-332,266,598,2400,3243,0.7,劉銀連,中國國民黨
高雄市苓雅區正言里,-164,223,387,2112,2935,0.7,古金川,無
高雄市苓雅區正道里,-144,462,606,3424,4819,0.7,楊舜堡,無
高雄市苓雅區民主里,22,493,471,3542,4889,0.7,陳文程,無
高雄市苓雅區永康里,-10,252,262,2159,2996,0.7,陳瑛定,無
高雄市苓雅區田西里,-396,163,559,1439,1989,0.7,郭國民,中國國民黨
高雄市苓雅區福人里,-48,196,244,2033,2897,0.7,曾黃金華,無
高雄市苓雅區福南里,-96,172,268,1893,2639,0.7,蘇文安,無
高雄市苓雅區福地里,-84,262,346,2425,3423,0.7,蔡添財,無
高雄市苓雅區福壽里,-184,154,338,1714,2371,0.7,郭寬洲,民主進步黨
高雄市苓雅區福居里,-221,245,466,2457,3474,0.7,吳明憲,民主進步黨
高雄市苓雅區福康里,-94,191,285,1946,2729,0.7,陳信吾,無
高雄市苓雅區福東里,-220,284,504,2441,3420,0.7,劉呂燕芬,無
高雄市苓雅區福海里,-354,125,479,1433,2004,0.7,廖富男,中國國民黨
高雄市苓雅區福祥里,-411,168,579,1596,2236,0.7,劉榮福,民主進步黨
高雄市苓雅區福西里,-273,185,458,1969,2773,0.7,黃正德,無
高雄市苓雅區福隆里,-265,309,574,2613,3669,0.7,郭彌堅,民主進步黨
高雄市苓雅區美田里,-391,120,511,1259,1796,0.7,吳金對,無
高雄市苓雅區苓中里,-88,193,281,1662,2271,0.7,吳敏寬,無
高雄市苓雅區苓昇里,-228,120,348,1297,1846,0.7,陳文喜,無
高雄市苓雅區苓東里,-58,136,194,1457,2091,0.7,楊玉鳳,無
高雄市苓雅區苓洲里,-87,169,256,1569,2255,0.7,吳弘宜,中國國民黨
高雄市苓雅區苓雅里,-63,151,214,1482,2105,0.7,郭釗琦,無
高雄市苓雅區英明里,-207,190,397,1757,2441,0.7,黃秀靜,無
高雄市苓雅區華堂里,-118,299,417,2526,3581,0.7,曾興德,無
高雄市苓雅區衛武里,-220,199,419,2024,2823,0.7,邱秀迷,無
高雄市苓雅區鼓中里,-400,82,482,1138,1603,0.7,郭明鴻,無
高雄市茂林區多納里,-220,47,267,351,490,0.7,羅耀明,中國國民黨
高雄市茂林區茂林里,-236,88,324,532,711,0.7,"田振弘 Kukui‧Pakadavy",中國國民黨
高雄市茂林區萬山里,-298,24,322,277,361,0.8,蔡正男,無
高雄市茄萣區保定里,-457,264,721,1989,2838,0.7,郭淑芬,無
高雄市茄萣區光定里,-185,90,275,575,871,0.7,林高華,無
高雄市茄萣區吉定里,-374,129,503,794,1088,0.7,薛賢成,無
高雄市茄萣區和協里,-404,122,526,1305,1979,0.7,吳進發,無
高雄市茄萣區嘉安里,-270,107,377,1143,1691,0.7,林陳麗雯,無
高雄市茄萣區嘉定里,-248,130,378,1338,1932,0.7,歐清信,無
高雄市茄萣區嘉樂里,-285,223,508,1970,2904,0.7,郭松南,無
高雄市茄萣區嘉泰里,-278,115,393,1295,1941,0.7,鄭君男,無
高雄市茄萣區嘉福里,-229,125,354,1224,1872,0.7,吳財榮,無
高雄市茄萣區嘉賜里,-145,449,594,2572,3697,0.7,葉宏信,民主進步黨
高雄市茄萣區大定里,-260,145,405,1340,1928,0.7,薛金成,無
高雄市茄萣區崎漏里,55,530,475,3124,4709,0.7,邱美麗,無
高雄市茄萣區白雲里,-86,168,254,1262,1682,0.8,郭麗華,無
高雄市茄萣區福德里,-230,142,372,1325,1786,0.7,陳茂生,無
高雄市茄萣區萬福里,-379,86,465,560,825,0.7,蘇永南,無
高雄市路竹區三爺里,-304,134,438,1209,1694,0.7,康庭琰,無
高雄市路竹區下坑里,-37,299,336,1853,2514,0.7,王金水,無
高雄市路竹區北嶺里,-321,161,482,1505,2074,0.7,黃松德,無
高雄市路竹區後鄉里,-328,244,572,1643,2190,0.8,金宜頵,無
高雄市路竹區文北里,110,429,319,2088,2855,0.7,陳慶宗,無
高雄市路竹區文南里,-185,244,429,1666,2196,0.8,許明嘉,無
高雄市路竹區新達里,-180,203,383,1563,2143,0.7,杜明昌,無
高雄市路竹區甲北里,3,377,374,2289,3262,0.7,王錦祥,無
高雄市路竹區甲南里,-80,325,405,2233,3174,0.7,黃吉松,無
高雄市路竹區社中里,-267,97,364,551,801,0.7,魏林寶菊,無
高雄市路竹區社南里,219,483,264,3286,4456,0.7,石永昌,中國國民黨
高雄市路竹區社東里,-87,285,372,2021,2696,0.7,蘇鑫,無
高雄市路竹區社西里,-303,227,530,1563,2148,0.7,馬旭來,無
高雄市路竹區竹南里,42,303,261,1818,2542,0.7,高月英,無
高雄市路竹區竹園里,-185,291,476,1874,2639,0.7,辛瑞賢,無
高雄市路竹區竹東里,57,482,425,2551,3375,0.8,程啓龍,無
高雄市路竹區竹滬里,-54,362,416,2148,3120,0.7,劉崑芳,無
高雄市路竹區竹西里,-243,264,507,1511,2061,0.7,黃李月施,無
高雄市路竹區頂寮里,-292,176,468,1482,2055,0.7,黃居賢,無
高雄市路竹區鴨寮里,-263,169,432,1367,1885,0.7,蘇清吉,無
高雄市那瑪夏區南沙魯里,-181,25,206,336,466,0.7,劉陳玉梅,無
高雄市那瑪夏區瑪雅里,-274,56,330,422,623,0.7,許利滿,無
高雄市那瑪夏區達卡努瓦里,-350,91,441,728,1328,0.5,朱子亮,無
高雄市阿蓮區中路里,-201,183,384,1361,1894,0.7,林永信,無
高雄市阿蓮區南蓮里,8,377,369,2017,2859,0.7,林首相,無
高雄市阿蓮區和蓮里,-370,216,586,1613,2224,0.7,陳秀裡,無
高雄市阿蓮區峯山里,-573,111,684,831,1167,0.7,鄭鴻哖,無
高雄市阿蓮區崗山里,-375,85,460,1064,1524,0.7,吳尚儒,無
高雄市阿蓮區復安里,-261,115,376,1118,1583,0.7,何榮華,中國國民黨
高雄市阿蓮區清蓮里,35,281,246,1746,2505,0.7,陳伯温,無
高雄市阿蓮區港後里,96,295,199,2166,3027,0.7,鄭文能,無
高雄市阿蓮區玉庫里,-441,133,574,1229,1756,0.7,鄭明聰,無
高雄市阿蓮區石安里,-373,172,545,1389,1954,0.7,蔡寬意,無
高雄市阿蓮區阿蓮里,58,564,506,3235,4661,0.7,黃靖娟,無
高雄市阿蓮區青旗里,-214,134,348,1008,1481,0.7,陳文曉,無
高雄市鳥松區仁美里,398,754,356,5185,7239,0.7,吳家儒,無
高雄市鳥松區坔埔里,-35,431,466,3050,4093,0.7,黃永順,民主進步黨
高雄市鳥松區夢裡里,124,669,545,4630,6272,0.7,陳萬丁,無
高雄市鳥松區大竹里,-350,20,370,534,735,0.7,蔡榮瑞,無
高雄市鳥松區大華里,891,1267,376,8285,10963,0.8,蔡美蘭,中國國民黨
高雄市鳥松區華美里,52,448,396,3224,4426,0.7,邱宏棋,無
高雄市鳥松區鳥松里,841,1155,314,7226,10276,0.7,謝唐欽,無
高雄市鳳山區一甲里,11,354,343,3052,4307,0.7,蔡瑋誠,無
高雄市鳳山區三民里,-435,140,575,1328,1881,0.7,黃榮貴,無
高雄市鳳山區中和里,-50,394,444,2907,3998,0.7,張簡進興,無
高雄市鳳山區中崙里,-193,214,407,1724,2446,0.7,林齊諒,無
高雄市鳳山區中榮里,-40,562,602,3049,4387,0.7,劉秀美,無
高雄市鳳山區中正里,-71,462,533,2957,4057,0.7,鄒家駿,中國國民黨
高雄市鳳山區中民里,-1,560,561,3887,5503,0.7,黃金利,無
高雄市鳳山區二甲里,123,600,477,4195,5727,0.7,黃昭雄,無
高雄市鳳山區五福里,-281,236,517,2143,2931,0.7,王劉煌,無
高雄市鳳山區保安里,572,992,420,5672,7576,0.7,謝昆政,無
高雄市鳳山區光明里,-453,154,607,1410,2067,0.7,王俊富,無
高雄市鳳山區北門里,-112,436,548,3226,4582,0.7,謝秀霞,民主進步黨
高雄市鳳山區協和里,-131,384,515,2721,3737,0.7,羅美滿,無
高雄市鳳山區南和里,-131,302,433,2520,3495,0.7,李錦珠,民主進步黨
高雄市鳳山區南成里,781,1355,574,7597,10424,0.7,楊居財,無
高雄市鳳山區南興里,-344,100,444,1157,1651,0.7,廖春花,無
高雄市鳳山區和德里,-155,454,609,2557,3567,0.7,吳金池,無
高雄市鳳山區和興里,124,549,425,3798,5161,0.7,周春生,無
高雄市鳳山區善美里,372,720,348,4541,6487,0.7,張育臺,民主進步黨
高雄市鳳山區國光里,-267,252,519,2254,3146,0.7,呂岳霖,無
高雄市鳳山區國富里,-51,352,403,2588,3488,0.7,陳振沛,無
高雄市鳳山區國泰里,11,374,363,3277,4587,0.7,黃昭清,無
高雄市鳳山區國隆里,-282,240,522,2363,3319,0.7,呂富貴,無
高雄市鳳山區埤頂里,25,696,671,4114,5683,0.7,謝順和,無
高雄市鳳山區大德里,11,508,497,4001,5662,0.7,侯俊傑,無
高雄市鳳山區天興里,48,398,350,3317,4676,0.7,郭秉鑫,無
高雄市鳳山區富榮里,-181,228,409,1666,2295,0.7,郭登臨,無
高雄市鳳山區富甲里,-89,237,326,1907,2722,0.7,王筱銜,無
高雄市鳳山區忠孝里,196,603,407,3872,5384,0.7,蔡美雪,無
高雄市鳳山區忠義里,48,615,567,3201,4309,0.7,李朝清,無
高雄市鳳山區忠誠里,-290,476,766,2994,4220,0.7,陳永壽,無
高雄市鳳山區成功里,-301,18,319,489,677,0.7,鄭美玉,無
高雄市鳳山區文山里,338,813,475,4414,6076,0.7,黃惠玲,民主進步黨
高雄市鳳山區文德里,555,1195,640,6791,9340,0.7,謝智華,無
高雄市鳳山區文福里,715,1405,690,6808,9205,0.7,余世善,無
高雄市鳳山區文英里,14,484,470,3066,4289,0.7,鄭鴻章,無
高雄市鳳山區文華里,317,1006,689,5785,7903,0.7,張嘉玲,無
高雄市鳳山區文衡里,179,573,394,3391,4798,0.7,洪啟修,無
高雄市鳳山區新富里,59,491,432,3640,5023,0.7,李金福,無
高雄市鳳山區新強里,194,581,387,3808,5118,0.7,李得勝,民主進步黨
高雄市鳳山區新樂里,-196,461,657,3018,4197,0.7,李滋宏,民主進步黨
高雄市鳳山區新武里,106,386,280,2799,3832,0.7,李戊琳,無
高雄市鳳山區新泰里,213,594,381,3733,5208,0.7,歐諺霖,無
高雄市鳳山區新甲里,-202,422,624,3050,4266,0.7,柯寶凱,無
高雄市鳳山區新興里,-15,184,199,1690,4213,0.4,郭傅美金,無
高雄市鳳山區曹公里,28,221,193,1884,2667,0.7,曾齡瑩,無
高雄市鳳山區東門里,323,713,390,4458,6389,0.7,劉晋祥,無
高雄市鳳山區正義里,108,588,480,4308,5925,0.7,鄭洂汯,無
高雄市鳳山區武慶里,7,349,342,2426,3303,0.7,張淑敏,無
高雄市鳳山區武松里,-74,305,379,2303,3349,0.7,戴惠敏,無
高雄市鳳山區武漢里,-85,487,572,3209,4534,0.7,蘇弘展,民主進步黨
高雄市鳳山區海光里,-115,344,459,2504,3549,0.7,鍾翠民,無
高雄市鳳山區海洋里,-14,520,534,3579,4810,0.7,蔡秀寶,無
高雄市鳳山區瑞竹里,-22,572,594,4172,5881,0.7,李美雲,中國國民黨
高雄市鳳山區瑞興里,-95,693,788,4104,5670,0.7,王玉蘭,中國國民黨
高雄市鳳山區生明里,-259,218,477,1947,2743,0.7,郭清竹,中國國民黨
高雄市鳳山區福祥里,-51,350,401,2915,4013,0.7,李安琪,無
高雄市鳳山區福興里,192,461,269,3799,5503,0.7,鄭陳麗珠,無
高雄市鳳山區福誠里,120,727,607,4522,6102,0.7,許德發,民主進步黨
高雄市鳳山區縣口里,-187,4,191,546,839,0.7,洪敏川,無
高雄市鳳山區縣衙里,-303,104,407,1106,1607,0.7,王鈴雅,中國國民黨
高雄市鳳山區老爺里,469,812,343,5511,7699,0.7,李菁雅,無
高雄市鳳山區興中里,-310,137,447,1192,1669,0.7,林天財,中國國民黨
高雄市鳳山區興仁里,-131,386,517,2864,3982,0.7,林曾桂花,無
高雄市鳳山區誠信里,-320,154,474,1451,2073,0.7,蔡自謄,中國國民黨
高雄市鳳山區誠德里,-69,324,393,2312,3290,0.7,陳世寳,中國國民黨
高雄市鳳山區誠智里,-126,309,435,1784,2595,0.7,黃桂花,中國國民黨
高雄市鳳山區誠義里,-53,549,602,3371,4501,0.7,劉啓芳,中國國民黨
高雄市鳳山區過埤里,1734,2148,414,10083,14164,0.7,莫尚忠,無
高雄市鳳山區鎮北里,971,1651,680,7706,10915,0.7,趙志成,無
高雄市鳳山區鎮南里,101,480,379,3290,4575,0.7,楊三吉,民主進步黨
高雄市鳳山區鎮東里,-207,339,546,2263,3248,0.7,張簡裕芳,無
高雄市鳳山區鎮西里,334,594,260,3921,5404,0.7,李陳金治,無
高雄市鳳山區鳳崗里,-420,128,548,1215,1658,0.7,董錦慧,中國國民黨
高雄市鳳山區鳳東里,299,800,501,4646,6325,0.7,蔡瑋寧,民主進步黨
高雄市鳳山區龍成里,-224,297,521,2564,3620,0.7,張芳瑋,無
高雄市鹽埕區中原里,-129,55,184,1316,1995,0.7,洪玄志,無
高雄市鹽埕區中山里,-429,156,585,1824,2726,0.7,易明忠,無
高雄市鹽埕區光明里,-469,6,475,920,1473,0.6,葛吉雄,無
高雄市鹽埕區南端里,-315,92,407,1532,2349,0.7,陳清標,無
高雄市鹽埕區博愛里,-217,45,262,1358,2060,0.7,林哲弘,無
高雄市鹽埕區壽星里,-234,115,349,1748,2689,0.7,黃強,無
高雄市鹽埕區府北里,-10,200,210,2290,3403,0.7,莊世權,無
高雄市鹽埕區慈愛里,-132,34,166,1138,1775,0.6,呂佳穎,無
高雄市鹽埕區教仁里,-147,202,349,2312,3322,0.7,高陳文玲,無
高雄市鹽埕區新化里,-239,65,304,1321,1991,0.7,夏麗鳳,無
高雄市鹽埕區新樂里,-207,88,295,1503,2236,0.7,黃昭翔,無
高雄市鹽埕區新豐里,-216,86,302,1474,2221,0.7,郭蘇元,無
高雄市鹽埕區江南里,-201,44,245,1292,2005,0.6,蔡德龍,民主進步黨
高雄市鹽埕區江西里,-414,99,513,1627,2448,0.7,鄭錫國,無
高雄市鹽埕區沙地里,-243,67,310,1394,2120,0.7,高健財,無
高雄市鹽埕區河濱里,-147,190,337,2046,2945,0.7,林德松,無
高雄市鹽埕區港都里,-345,81,426,1650,2445,0.7,邱誌雲,民主進步黨
高雄市鹽埕區瀨南里,-151,49,200,1308,1994,0.7,邱有洧,無
高雄市鹽埕區育仁里,-278,65,343,1434,2189,0.7,葛有力,無
高雄市鹽埕區藍橋里,-258,166,424,1831,2684,0.7,陳本興,中國國民黨
高雄市鹽埕區陸橋里,-362,111,473,1661,2512,0.7,許梅娟,民主進步黨
高雄市鼓山區光化里,-323,122,445,1622,2325,0.7,周國城,無
高雄市鼓山區光榮里,66,375,309,3695,5080,0.7,葉文朗,無
高雄市鼓山區內惟里,-342,136,478,2009,2793,0.7,林進發,無
高雄市鼓山區前峰里,-64,430,494,4110,5637,0.7,盧明惠,中國國民黨
高雄市鼓山區厚生里,-334,342,676,2854,3964,0.7,歐瑞清,無
高雄市鼓山區哨船頭里,-221,100,321,1449,2077,0.7,楊宗正,無
高雄市鼓山區壽山里,-427,121,548,1628,2383,0.7,陳進興,民主進步黨
高雄市鼓山區寶樹里,-369,111,480,1584,3034,0.5,王登科,無
高雄市鼓山區山下里,-347,143,490,1705,2378,0.7,杜文瑞,中國國民黨
高雄市鼓山區峰南里,-370,52,422,1284,1867,0.7,王宋金花,中國國民黨
高雄市鼓山區平和里,-314,356,670,3703,5014,0.7,陳玉芳,民主進步黨
高雄市鼓山區延平里,-250,71,321,1303,1827,0.7,洪蔡愛玉,無
高雄市鼓山區建國里,0,287,287,3067,4117,0.7,林福祥,無
高雄市鼓山區忠正里,-163,392,555,3809,5270,0.7,洪吉祥,無
高雄市鼓山區惠安里,-367,122,489,1516,2180,0.7,洪進成,無
高雄市鼓山區新民里,-354,92,446,1462,2066,0.7,洪宗郁,無
高雄市鼓山區明誠里,1645,2085,440,11423,16134,0.7,胡景森,中國國民黨
高雄市鼓山區桃源里,-179,53,232,1162,1645,0.7,李慶賢,無
高雄市鼓山區樹德里,-437,110,547,1605,2213,0.7,黃武田,無
高雄市鼓山區正德里,-680,192,872,2648,3651,0.7,朱榮俊,中國國民黨
高雄市鼓山區民強里,-203,242,445,3068,4228,0.7,歐華美,無
高雄市鼓山區民族里,-587,155,742,2239,3017,0.7,朱春木,中國國民黨
高雄市鼓山區河邊里,-378,6,384,795,1154,0.7,曾茂信,中國國民黨
高雄市鼓山區登山里,-295,64,359,1178,1726,0.7,許永堃,無
高雄市鼓山區綠川里,-388,130,518,1737,2419,0.7,郭國華,無
高雄市鼓山區維生里,-447,109,556,1599,2286,0.7,董錦昌,無
高雄市鼓山區自強里,-276,63,339,1768,2466,0.7,方紹義,中國國民黨
高雄市鼓山區興宗里,-520,100,620,1628,2332,0.7,楊孟翰,無
高雄市鼓山區華豐里,-75,485,560,3972,5368,0.7,黃明洲,中國國民黨
高雄市鼓山區裕興里,-87,418,505,3529,4789,0.7,曾榮發,中國國民黨
高雄市鼓山區裕豐里,-375,313,688,2966,4086,0.7,周恆功,中國國民黨
高雄市鼓山區雄峰里,-9,247,256,2545,3637,0.7,楊惠茵,中國國民黨
高雄市鼓山區麗興里,-306,85,391,1410,2046,0.7,王志斌,無
高雄市鼓山區鼓岩里,-357,100,457,1530,2243,0.7,方國智,無
高雄市鼓山區鼓峰里,-197,253,450,2552,3589,0.7,麥克士,中國國民黨
高雄市鼓山區龍井里,-302,116,418,2113,2944,0.7,周明吉,無
高雄市鼓山區龍子里,1900,2227,327,12494,17093,0.7,蘇彥傑,無
高雄市鼓山區龍水里,2731,3308,577,17774,24168,0.7,初學霖,民主進步黨
