村里,2024-2022,2024民眾黨,2022村里長得票,2024投票數,2024選舉人數,2024投票率,里長姓名,里長政黨
高雄市三民區力行里,-261,109,370,710,1045,67.94,李水池,中國國民黨
高雄市三民區十全里,-382,190,572,604,813,74.29,洪能通,無
高雄市三民區十美里,-168,89,257,637,852,74.77,蔡灯能,民主進步黨
高雄市三民區千北里,-393,98,491,710,1045,67.94,黃林麗香,無
高雄市三民區千歲里,-467,113,580,710,1045,67.94,許婉羚,無
高雄市三民區千秋里,-138,172,310,710,1045,67.94,蔡文和,無
高雄市三民區博惠里,-6,382,388,710,1045,67.94,洪耀斌,無
高雄市三民區博愛里,-482,137,619,710,1045,67.94,鍾秋美,無
高雄市三民區同德里,-119,264,383,952,1273,74.78,陳清源,無
高雄市三民區安吉里,98,608,510,969,1471,65.87,王明文,無
高雄市三民區安和里,-397,300,697,857,1125,76.18,傅秋陽,民主進步黨
高雄市三民區安宜里,-319,334,653,1175,1564,75.13,周黃俊宇,無
高雄市三民區安寧里,-213,169,382,969,1471,65.87,郭海定,民主進步黨
高雄市三民區安康里,-151,150,301,855,1322,64.67,孫聖雄,無
高雄市三民區安東里,-123,391,514,1152,1478,77.94,林添祥,無
高雄市三民區安泰里,-36,403,439,833,1117,74.57,謝明學,無
高雄市三民區安生里,-274,211,485,1190,1596,74.56,余許淑女,無
高雄市三民區安發里,134,486,352,969,1471,65.87,許峻溢,無
高雄市三民區安邦里,43,452,409,865,1200,72.08,黃崑山,無
高雄市三民區寶中里,-79,320,399,997,1373,72.61,任憲慶,中國國民黨
高雄市三民區寶國里,712,1028,316,996,1434,69.46,黃兆華,民主進步黨
高雄市三民區寶安里,444,831,387,935,1245,75.10,黃柏澤,中國國民黨
高雄市三民區寶德里,145,582,437,885,1176,75.26,潘進派,民主進步黨
高雄市三民區寶慶里,-39,307,346,996,1434,69.46,陳昱昌,無
高雄市三民區寶業里,146,832,686,996,1434,69.46,林煥然,民主進步黨
高雄市三民區寶民里,-230,402,632,996,1434,69.46,陳詩椿,無
高雄市三民區寶泰里,48,359,311,871,1239,70.30,黃仲霖,民主進步黨
高雄市三民區寶獅里,-94,449,543,721,987,73.05,林昆明,無
高雄市三民區寶玉里,729,1121,392,996,1434,69.46,黃昱椉,無
高雄市三民區寶珠里,-9,592,601,1124,3192,35.21,陳榮增,民主進步黨
高雄市三民區寶盛里,170,603,433,1147,1549,74.05,任天霸,無
高雄市三民區寶興里,379,804,425,883,1187,74.39,許慶銘,無
高雄市三民區寶華里,-230,403,633,996,1434,69.46,李清樺,無
高雄市三民區寶龍里,-136,442,578,931,1272,73.19,黃美琴,無
高雄市三民區川東里,-505,106,611,710,1045,67.94,李明海,無
高雄市三民區建東里,-302,123,425,710,1045,67.94,陳建藏,無
高雄市三民區德仁里,-240,200,440,618,869,71.12,袁碧嬌,民主進步黨
高雄市三民區德北里,-6,265,271,710,1045,67.94,李仁祥,無
高雄市三民區德智里,-65,203,268,715,913,78.31,李明同,民主進步黨
高雄市三民區德東里,-344,83,427,547,710,77.04,許玉秀,無
高雄市三民區德行里,-371,93,464,768,1006,76.34,郭麗香,無
高雄市三民區德西里,-366,365,731,710,1045,67.94,林財旺,無
高雄市三民區本上里,124,620,496,1077,1473,73.12,詹鶴,無
高雄市三民區本元里,306,644,338,899,1187,75.74,吳朝桂,民主進步黨
高雄市三民區本和里,319,926,607,987,1346,73.33,陳文旗,無
高雄市三民區本安里,288,588,300,1050,1410,74.47,王金堂,民主進步黨
高雄市三民區本揚里,557,939,382,1083,1427,75.89,蘇永樹,無
高雄市三民區本文里,-153,138,291,696,965,72.12,郭和成,民主進步黨
高雄市三民區本武里,4,197,193,685,907,75.52,吳阿吉,民主進步黨
高雄市三民區本館里,417,1043,626,986,1350,73.04,簡明鎮,無
高雄市三民區正興里,1324,1670,346,977,1432,68.23,沈秀玲,民主進步黨
高雄市三民區正順里,10,476,466,851,1193,71.33,黃冠惠,無
高雄市三民區民享里,-91,175,266,674,906,74.39,吳慶東,無
高雄市三民區港新里,-132,157,289,710,1045,67.94,蘇麗玉,無
高雄市三民區港東里,-554,116,670,710,1045,67.94,張士賢,無
高雄市三民區港西里,-277,65,342,710,1045,67.94,閩興傳,民主進步黨
高雄市三民區灣中里,111,608,497,751,1024,73.34,楊宏明,無
高雄市三民區灣利里,-324,271,595,751,1024,73.34,郭峻毅,民主進步黨
高雄市三民區灣勝里,-255,161,416,751,1024,73.34,陳金櫃,民主進步黨
高雄市三民區灣子里,110,456,346,751,1024,73.34,方相茗,無
高雄市三民區灣復里,-30,425,455,751,1024,73.34,吳國清,無
高雄市三民區灣愛里,-67,302,369,751,1024,73.34,邱清勳,無
高雄市三民區灣成里,-144,393,537,751,1024,73.34,黃文良,無
高雄市三民區灣興里,-119,205,324,751,1024,73.34,張文青,無
高雄市三民區灣華里,-46,330,376,751,1024,73.34,高素女,中國國民黨
高雄市三民區立德里,-298,121,419,710,1045,67.94,林平長,中國國民黨
高雄市三民區立業里,-335,91,426,710,1045,67.94,陳姵羽,無
高雄市三民區立誠里,-236,60,296,710,1045,67.94,陳永進,中國國民黨
高雄市三民區精華里,-504,141,645,1052,1415,74.35,何佳憲,民主進步黨
高雄市三民區興德里,-71,238,309,710,1045,67.94,陳國欽,無
高雄市三民區裕民里,-259,164,423,710,1045,67.94,陳水榮,無
高雄市三民區豐裕里,-134,228,362,710,1045,67.94,謝錫元,無
高雄市三民區達仁里,-480,167,647,983,1315,74.75,邱添富,民主進步黨
高雄市三民區達勇里,-190,95,285,609,853,71.40,李少緯,無
高雄市三民區達德里,-462,135,597,906,1184,76.52,陳國枝,無
高雄市三民區達明里,-629,143,772,1053,1447,72.77,張簡王玉珠,民主進步黨
高雄市三民區長明里,-340,107,447,710,1045,67.94,林練丁,無
高雄市三民區鳳北里,-501,129,630,710,1045,67.94,鄭健村,無
高雄市三民區鳳南里,-315,114,429,710,1045,67.94,王進祿,無
高雄市三民區鼎中里,-69,484,553,1073,1518,70.69,李水發,無
高雄市三民區鼎力里,-33,519,552,1073,1518,70.69,沈巽榮,無
高雄市三民區鼎強里,-85,307,392,817,1197,68.25,林國石,無
高雄市三民區鼎泰里,2072,2799,727,1073,1518,70.69,張吉雄,無
高雄市三民區鼎盛里,594,991,397,1015,1473,68.91,謝有清,民主進步黨
高雄市三民區鼎西里,374,935,561,1073,1518,70.69,姚素眞,民主進步黨
高雄市三民區鼎金里,-103,454,557,787,1189,66.19,高豐麟,無
高雄市仁武區中華里,-564,182,746,1079,1563,69.03,林志榮,民主進步黨
高雄市仁武區五和里,514,772,258,981,1468,66.83,林雅婷,民主進步黨
高雄市仁武區仁和里,90,438,348,934,1253,74.54,鄭諭澤,無
高雄市仁武區仁慈里,44,400,356,924,1287,71.79,洪月琴,民主進步黨
高雄市仁武區仁武里,53,677,624,984,1354,72.67,劉俊彥,無
高雄市仁武區仁福里,-391,64,455,557,825,67.52,朱興,無
高雄市仁武區八卦里,2391,2929,538,1088,1579,68.90,謝秋江,無
高雄市仁武區大灣里,171,665,494,1096,1459,75.12,謝瑋原,民主進步黨
高雄市仁武區後安里,-293,266,559,878,1233,71.21,黃榮輝,無
高雄市仁武區文武里,846,1236,390,1084,1496,72.46,蔡進德,無
高雄市仁武區灣內里,554,1154,600,1010,1400,72.14,鄭文輝,民主進步黨
高雄市仁武區烏林里,-95,412,507,739,1112,66.46,林文斌,民主進步黨
高雄市仁武區竹後里,-203,217,420,773,1046,73.90,黃常志,無
高雄市仁武區考潭里,-112,282,394,921,1285,71.67,蔡德明,無
高雄市仁武區赤山里,596,1030,434,1030,1378,74.75,謝青原,民主進步黨
高雄市仁武區高楠里,-133,486,619,1123,1538,73.02,李志能,無
高雄市內門區三平里,-266,56,322,389,604,64.40,洪生業,無
高雄市內門區中埔里,-226,39,265,363,514,70.62,謝清雄,無
高雄市內門區光興里,-215,71,286,431,616,69.97,王士訓,無
高雄市內門區內南里,-137,34,171,249,381,65.35,沈芳昌,無
高雄市內門區內東里,-302,46,348,508,713,71.25,陳明章,無
高雄市內門區內興里,-215,29,244,352,572,61.54,力永信,無
高雄市內門區內豊里,-526,85,611,765,1112,68.79,龔飛盛,無
高雄市內門區內門里,-461,79,540,625,896,69.75,蔡瓊鳳,無
高雄市內門區木柵里,-270,40,310,370,556,66.55,机素勤,無
高雄市內門區東埔里,-170,43,213,302,458,65.94,張錦泉,無
高雄市內門區永吉里,-144,23,167,248,404,61.39,李永坤,無
高雄市內門區永富里,-410,70,480,602,926,65.01,蒙勝南,無
高雄市內門區永興里,-121,28,149,240,370,64.86,陳順良,無
高雄市內門區溝坪里,-292,66,358,531,877,60.55,謝振明,無
高雄市內門區瑞山里,-139,21,160,206,302,68.21,黄淑玲,無
高雄市內門區石坑里,-179,43,222,312,477,65.41,劉文斌,無
高雄市內門區觀亭里,-247,158,405,521,777,67.05,許志芳,無
高雄市內門區金竹里,-268,36,304,401,603,66.50,林熾杉,無
高雄市六龜區中興里,-222,118,340,843,1354,62.26,陳信景,無
高雄市六龜區六龜里,-243,54,297,468,894,52.35,邱國輝,無
高雄市六龜區大津里,-84,30,114,210,291,72.16,林文察,無
高雄市六龜區寶來里,-260,50,310,478,823,58.08,沈振揚,無
高雄市六龜區文武里,-366,92,458,746,1321,56.47,鍾達煌,無
高雄市六龜區新威里,-211,52,263,430,675,63.70,邱民棟,無
高雄市六龜區新寮里,-289,38,327,401,596,67.28,朱玉雲,無
高雄市六龜區新發里,-340,52,392,470,880,53.41,劉俊麟,無
高雄市六龜區新興里,-260,51,311,381,626,60.86,邱瑞明,無
高雄市六龜區義寶里,-237,69,306,593,954,62.16,鍾啟鴻,無
高雄市六龜區興龍里,-310,34,344,407,742,54.85,張榮華,無
高雄市六龜區荖濃里,-256,90,346,708,1305,54.25,陳俊福,無
高雄市前金區三川里,-106,136,242,655,856,76.52,莊晉勲,無
高雄市前金區北金里,-178,86,264,557,778,71.59,林福枝,無
高雄市前金區博孝里,-222,104,326,652,909,71.73,方文杰,民主進步黨
高雄市前金區國民里,-192,94,286,652,909,71.73,謝明致,無
高雄市前金區後金里,-226,80,306,439,593,74.03,施孟均,無
高雄市前金區復元里,-374,93,467,652,909,71.73,黃千豪,無
高雄市前金區文東里,-265,135,400,652,909,71.73,黃崑光,無
高雄市前金區文西里,-321,113,434,652,909,71.73,賴勇村,無
高雄市前金區新生里,-92,451,543,870,1178,73.85,康文展,無
高雄市前金區東金里,-389,82,471,639,916,69.76,謝仲箎,無
高雄市前金區林投里,-194,91,285,652,909,71.73,李明峰,無
高雄市前金區榮復里,-396,103,499,652,909,71.73,顏炳豪,無
高雄市前金區民生里,-181,6,187,652,909,71.73,黃博群,無
高雄市前金區社東里,-161,139,300,652,909,71.73,黃玉英,無
高雄市前金區社西里,-359,154,513,652,909,71.73,薛寶琴,無
高雄市前金區草江里,-357,178,535,933,1316,70.90,陳振琦,無
高雄市前金區長城里,-310,118,428,892,1289,69.20,李林春蘭,無
高雄市前金區長生里,-276,167,443,652,909,71.73,陳宗佐,無
高雄市前金區長興里,-427,154,581,826,1176,70.24,白宗正,無
高雄市前金區青山里,-55,214,269,638,898,71.05,江武吉,無
高雄市前鎮區仁愛里,-369,133,502,562,843,66.67,楊朝雄,民主進步黨
高雄市前鎮區信德里,-331,224,555,633,854,74.12,李竣帆,無
高雄市前鎮區信義里,-486,130,616,896,1264,70.89,魏伯曆,民主進步黨
高雄市前鎮區前鎮里,-321,127,448,883,1196,73.83,許澤能,無
高雄市前鎮區平昌里,-225,62,287,562,843,66.67,高琅璋,民主進步黨
高雄市前鎮區平等里,-219,190,409,562,843,66.67,施長欽,民主進步黨
高雄市前鎮區建隆里,-301,142,443,1165,1644,70.86,林得祿,中國國民黨
高雄市前鎮區復國里,-334,272,606,877,1223,71.71,呂建霖,民主進步黨
高雄市前鎮區德昌里,-97,184,281,556,804,69.15,李正義,無
高雄市前鎮區忠孝里,41,423,382,1183,1654,71.52,陳宜汝,無
高雄市前鎮區忠純里,175,580,405,1165,1644,70.86,艾台民,中國國民黨
高雄市前鎮區忠誠里,-271,202,473,1165,1644,70.86,吳安美,中國國民黨
高雄市前鎮區振興里,-146,304,450,1165,1644,70.86,鍾明憲,無
高雄市前鎮區明孝里,-56,176,232,569,797,71.39,林浤澤,無
高雄市前鎮區明正里,290,590,300,562,843,66.67,王春茂,民主進步黨
高雄市前鎮區明禮里,-599,162,761,562,843,66.67,莊志明,民主進步黨
高雄市前鎮區明義里,-161,236,397,562,843,66.67,翁碩聰,無
高雄市前鎮區明道里,-393,90,483,562,843,66.67,王進亨,民主進步黨
高雄市前鎮區民權里,-95,471,566,1165,1644,70.86,吳政昇,無
高雄市前鎮區瑞北里,-205,367,572,1032,1449,71.22,陳眞玟,民主進步黨
高雄市前鎮區瑞南里,97,549,452,1032,1449,71.22,張木春,民主進步黨
高雄市前鎮區瑞和里,-164,184,348,1032,1449,71.22,陳文人,民主進步黨
高雄市前鎮區瑞崗里,-189,273,462,1032,1449,71.22,洪金山,民主進步黨
高雄市前鎮區瑞平里,42,415,373,1032,1449,71.22,陳柏村,無
高雄市前鎮區瑞文里,-126,274,400,1032,1449,71.22,邱吉弘,無
高雄市前鎮區瑞昌里,70,387,317,1032,1449,71.22,陳裕達,無
高雄市前鎮區瑞東里,-220,254,474,1032,1449,71.22,許振稽,民主進步黨
高雄市前鎮區瑞祥里,236,566,330,1032,1449,71.22,陳紫鳳,無
高雄市前鎮區瑞竹里,-59,390,449,1032,1449,71.22,許益彰,無
高雄市前鎮區瑞興里,-214,245,459,1032,1449,71.22,陳俊源,民主進步黨
高雄市前鎮區瑞華里,-175,510,685,1032,1449,71.22,蘇榮隆,無
高雄市前鎮區瑞西里,-199,251,450,1032,1449,71.22,蘇悦敏,民主進步黨
高雄市前鎮區瑞誠里,-114,329,443,1032,1449,71.22,林雪娥,無
高雄市前鎮區瑞豐里,5,334,329,1032,1449,71.22,王森騰,民主進步黨
高雄市前鎮區瑞隆里,-106,385,491,1032,1449,71.22,楊家鴻,無
高雄市前鎮區盛興里,-141,277,418,901,1307,68.94,鍾鳳美,無
高雄市前鎮區盛豐里,-320,318,638,1023,1439,71.09,王志濱,無
高雄市前鎮區竹中里,33,392,359,1032,1449,71.22,莊茂榮,無
高雄市前鎮區竹內里,-307,169,476,1027,1435,71.57,蘇慶忠,無
高雄市前鎮區竹北里,60,349,289,1032,1449,71.22,孫偉光,無
高雄市前鎮區竹南里,634,969,335,1032,1449,71.22,張銓聖,無
高雄市前鎮區竹東里,-218,229,447,1032,1449,71.22,李春桂,無
高雄市前鎮區竹西里,-142,491,633,1032,1449,71.22,林金良,無
高雄市前鎮區興中里,10,314,304,641,905,70.83,狄金山,中國國民黨
高雄市前鎮區興仁里,-283,71,354,458,615,74.47,張秋敏,無
高雄市前鎮區興化里,-284,72,356,434,605,71.74,朱蘇來蔭,無
高雄市前鎮區興東里,116,716,600,907,1299,69.82,陳建銘,無
高雄市前鎮區興邦里,-285,215,500,1165,1644,70.86,薛文龍,無
高雄市前鎮區良和里,-269,328,597,1165,1644,70.86,陳瑞銓,中國國民黨
高雄市前鎮區草衙里,440,984,544,655,901,72.70,李忠正,無
高雄市前鎮區西山里,-30,339,369,1165,1644,70.86,陳天香,無
高雄市前鎮區西甲里,-59,210,269,1165,1644,70.86,潘石誠,民主進步黨
高雄市前鎮區鎮中里,-352,99,451,1165,1644,70.86,湯淑貞,無
高雄市前鎮區鎮北里,-487,118,605,1165,1644,70.86,許昭福,無
高雄市前鎮區鎮昌里,-201,218,419,704,965,72.95,涂明鏡,無
高雄市前鎮區鎮東里,-272,182,454,615,778,79.05,蔡川士,無
高雄市前鎮區鎮榮里,-315,203,518,657,923,71.18,黃士誠,民主進步黨
高雄市前鎮區鎮海里,97,480,383,824,1254,65.71,蔡葉珍妮,民主進步黨
高雄市前鎮區鎮陽里,-307,102,409,632,887,71.25,鄭蔡秀燕,無
高雄市大寮區三隆里,191,534,343,908,1290,70.39,蕭國欽,民主進步黨
高雄市大寮區上寮里,2,402,400,859,1248,68.83,洪巧璇,無
高雄市大寮區中庄里,1189,1407,218,919,1297,70.86,林烔彬,無
高雄市大寮區中興里,227,593,366,865,1289,67.11,曾幸福,中國國民黨
高雄市大寮區內坑里,473,639,166,924,1363,67.79,俞金富,無
高雄市大寮區前庄里,-82,255,337,914,1254,72.89,陳金晚,中國國民黨
高雄市大寮區大寮里,468,742,274,718,1082,66.36,蕭清翔,無
高雄市大寮區山頂里,488,936,448,886,1273,69.60,簡子銘,中國國民黨
高雄市大寮區後庄里,556,980,424,764,1032,74.03,鄭德文,無
高雄市大寮區忠義里,-85,119,204,318,473,67.23,邴健鵬,中國國民黨
高雄市大寮區拷潭里,-174,135,309,468,655,71.45,董鳳松,民主進步黨
高雄市大寮區新厝里,-55,175,230,627,901,69.59,張簡龍星,無
高雄市大寮區昭明里,45,436,391,874,1277,68.44,張簡助昇,無
高雄市大寮區會社里,195,647,452,784,1101,71.21,吳銀國,無
高雄市大寮區會結里,-150,115,265,576,848,67.92,蔡金獅,中國國民黨
高雄市大寮區永芳里,336,811,475,659,1000,65.90,簡基成,無
高雄市大寮區江山里,-220,166,386,653,896,72.88,許世川,無
高雄市大寮區溪寮里,-125,223,348,558,748,74.60,王基安,無
高雄市大寮區潮寮里,-97,358,455,673,953,70.62,徐新生,無
高雄市大寮區琉球里,358,713,355,1009,1354,74.52,郭秀品,無
高雄市大寮區義仁里,-271,157,428,705,1016,69.39,許明得,無
高雄市大寮區義和里,-355,248,603,700,945,74.07,劉志陽,無
高雄市大寮區翁園里,165,506,341,922,1231,74.90,蔡順豐,無
高雄市大寮區過溪里,-111,316,427,840,1161,72.35,陳秀英,無
高雄市大樹區三和里,-245,163,408,920,1362,67.55,黃重信,無
高雄市大樹區久堂里,-154,484,638,949,1372,69.17,張勝鋒,中國國民黨
高雄市大樹區九曲里,77,623,546,902,1383,65.22,潘德勝,中國國民黨
高雄市大樹區井腳里,-71,141,212,540,719,75.10,黃沼人,無
高雄市大樹區和山里,-382,90,472,663,957,69.28,吳順治,無
高雄市大樹區大坑里,-465,66,531,920,1362,67.55,吳進雄,無
高雄市大樹區大樹里,-11,339,350,862,1222,70.54,梁源泰,無
高雄市大樹區姑山里,-293,93,386,691,952,72.58,王莊素真,無
高雄市大樹區小坪里,-408,130,538,892,1252,71.25,郭秀密,無
高雄市大樹區檨腳里,-66,258,324,862,1222,70.54,吳文雄,無
高雄市大樹區水安里,-131,261,392,775,1068,72.57,林正道,無
高雄市大樹區水寮里,-374,217,591,777,1062,73.16,史榮瑞,無
高雄市大樹區溪埔里,-107,140,247,512,723,70.82,張耀珍,無
高雄市大樹區竹寮里,-347,331,678,903,1296,69.68,鄭榕華,無
高雄市大樹區統嶺里,-262,42,304,438,626,69.97,許瑞楠,無
高雄市大樹區興山里,-353,138,491,862,1222,70.54,尹平成,無
高雄市大樹區興田里,-240,133,373,674,939,71.78,曾金益,中國國民黨
高雄市大樹區龍目里,-230,154,384,603,825,73.09,陳榮清,無
高雄市大社區三奶里,35,297,262,710,1019,69.68,許丁春,無
高雄市大社區中里里,-45,375,420,762,1051,72.50,李旭仁,無
高雄市大社區保安里,-41,434,475,684,1011,67.66,林義萬,民主進步黨
高雄市大社區保社里,118,447,329,712,1000,71.20,許清泉,民主進步黨
高雄市大社區嘉誠里,-331,89,420,576,855,67.37,侯景耀,無
高雄市大社區大社里,424,590,166,686,996,68.88,林英陸,民主進步黨
高雄市大社區神農里,290,634,344,884,1236,71.52,葉秀英,無
高雄市大社區翠屏里,-116,173,289,483,678,71.24,匡淑芳,無
高雄市大社區觀音里,375,668,293,804,1095,73.42,陳竑憲,無
高雄市小港區三苓里,-132,320,452,882,1267,69.61,郭冠霖,無
高雄市小港區中厝里,38,440,402,1002,1626,61.62,方蒼賢,無
高雄市小港區二苓里,71,388,317,847,1219,69.48,馮見仁,無
高雄市小港區六苓里,-270,191,461,1116,1679,66.47,陳美秀,無
高雄市小港區合作里,-230,325,555,1002,1626,61.62,蘇麗美,民主進步黨
高雄市小港區坪頂里,324,763,439,781,1149,67.97,梁憲宗,無
高雄市小港區大坪里,-258,378,636,837,1200,69.75,梁正義,無
高雄市小港區大苓里,-172,294,466,783,1097,71.38,歐世緯,無
高雄市小港區孔宅里,178,494,316,935,1212,77.15,吳蘆恩,無
高雄市小港區宏亮里,-164,388,552,1116,1679,66.47,宋震寶,無
高雄市小港區小港里,-255,148,403,1147,1684,68.11,洪世春,無
高雄市小港區山明里,1150,1509,359,821,1243,66.05,陳阿子,無
高雄市小港區山東里,67,360,293,980,1392,70.40,楊坤止,無
高雄市小港區店鎮里,86,616,530,1004,1468,68.39,楊文良,無
高雄市小港區廈莊里,346,622,276,1002,1626,61.62,李茂群,無
高雄市小港區松山里,-201,395,596,1231,1611,76.41,王美華,無
高雄市小港區松金里,-285,262,547,1067,1521,70.15,沈添福,無
高雄市小港區桂林里,557,1034,477,1002,1626,61.62,侯原庭,無
高雄市小港區正苓里,-56,463,519,889,1313,67.71,吳惠加,無
高雄市小港區泰山里,-153,393,546,948,1385,68.45,吳莧山,無
高雄市小港區港南里,-35,398,433,1147,1684,68.11,王秋宏,無
高雄市小港區港口里,-85,356,441,1147,1684,68.11,劉峰吉,無
高雄市小港區港后里,-298,310,608,1147,1684,68.11,柯文世,民主進步黨
高雄市小港區港墘里,-471,216,687,1147,1684,68.11,吳文德,無
高雄市小港區港明里,-298,355,653,1147,1684,68.11,李文正,無
高雄市小港區港正里,-334,312,646,1147,1684,68.11,方林秀娥,無
高雄市小港區港興里,-185,293,478,1147,1684,68.11,歐慧玲,民主進步黨
高雄市小港區濟南里,110,478,368,948,1385,68.45,薛審,無
高雄市小港區青島里,-465,139,604,762,1032,73.84,戴又媛,中國國民黨
高雄市小港區順苓里,196,568,372,1009,1493,67.58,呂在和,無
高雄市小港區高松里,44,550,506,804,1241,64.79,梁志安,無
高雄市小港區鳳宮里,-174,358,532,915,1329,68.85,曾清全,無
高雄市小港區鳳林里,-213,302,515,999,1448,68.99,許再生,民主進步黨
高雄市小港區鳳森里,-123,245,368,714,1039,68.72,陳信雄,無
高雄市小港區鳳源里,-223,302,525,760,1122,67.74,張宇讚,無
高雄市小港區鳳興里,-293,311,604,835,1201,69.53,洪富賢,無
高雄市小港區鳳鳴里,-383,349,732,912,1345,67.81,李月雲,無
高雄市小港區龍鳳里,-279,333,612,957,1449,66.05,黃文裕,無
高雄市岡山區三和里,-307,88,395,614,838,73.27,陳泰龍,無
高雄市岡山區仁壽里,-66,365,431,759,998,76.05,劉永裕,無
高雄市岡山區仁義里,-337,178,515,695,893,77.83,顏茂吉,無
高雄市岡山區信義里,14,251,237,554,804,68.91,石秀霞,無
高雄市岡山區前峰里,-370,369,739,948,1292,73.37,蔡佩玲,無
高雄市岡山區劉厝里,-366,163,529,1040,1362,76.36,劉慶煌,民主進步黨
高雄市岡山區協和里,-188,464,652,869,1202,72.30,呂煌龍,無
高雄市岡山區協榮里,-81,256,337,634,863,73.46,蔡麗琴,無
高雄市岡山區台上里,293,816,523,958,1280,74.84,李金本,無
高雄市岡山區和平里,-76,77,153,336,424,79.25,葉春蘭,無
高雄市岡山區嘉峰里,75,201,126,1008,1400,72.00,高昭南,無
高雄市岡山區嘉興里,-26,368,394,742,982,75.56,蔡宜眞,無
高雄市岡山區壽天里,-173,407,580,646,889,72.67,莊証州,無
高雄市岡山區壽峰里,-346,296,642,688,915,75.19,李美麗,無
高雄市岡山區大莊里,-254,99,353,691,953,72.51,佘能文,無
高雄市岡山區大遼里,-447,166,613,1017,1353,75.17,蔡錫琛,無
高雄市岡山區岡山里,176,535,359,937,1315,71.25,劉天賦,無
高雄市岡山區平安里,-191,162,353,759,1025,74.05,劉登榮,無
高雄市岡山區後協里,251,635,384,922,1261,73.12,李再富,無
高雄市岡山區後紅里,26,579,553,967,1318,73.37,韓嘉嘉,無
高雄市岡山區忠孝里,174,300,126,893,1249,71.50,江國華,中國國民黨
高雄市岡山區本洲里,-49,206,255,575,785,73.25,施清德,無
高雄市岡山區潭底里,-372,71,443,562,760,73.95,陳勝傑,無
高雄市岡山區灣裡里,-191,226,417,703,967,72.70,林仁傑,無
高雄市岡山區為隨里,-112,181,293,514,652,78.83,蔡正旭,無
高雄市岡山區白米里,22,281,259,729,961,75.86,曾詠妮,無
高雄市岡山區石潭里,-345,208,553,620,815,76.07,廖壹正,無
高雄市岡山區碧紅里,197,503,306,867,1201,72.19,李有財,無
高雄市岡山區福興里,-373,139,512,801,1029,77.84,何進柱,無
高雄市岡山區程香里,269,529,260,946,1293,73.16,李州正,無
高雄市岡山區竹圍里,579,1015,436,867,1226,70.72,何榮裕,無
高雄市岡山區維仁里,-256,47,303,675,926,72.89,戴清福,無
高雄市岡山區華崗里,-273,175,448,538,682,78.89,杜光達,無
高雄市左營區中北里,-312,43,355,405,543,74.59,謝瑞真,無
高雄市左營區中南里,-214,35,249,318,460,69.13,蔣金守,無
高雄市左營區光輝里,-69,278,347,443,643,68.90,傅琪隆,中國國民黨
高雄市左營區合群里,-209,251,460,443,643,68.90,倪同慧,中國國民黨
高雄市左營區城南里,-197,40,237,447,666,67.12,謝金得,無
高雄市左營區埤北里,-212,105,317,447,666,67.12,李復慶,無
高雄市左營區埤東里,-314,71,385,447,666,67.12,鄒秀華,中國國民黨
高雄市左營區埤西里,-321,72,393,447,666,67.12,余清榮,無
高雄市左營區尾北里,-263,371,634,992,1380,71.88,柯錦德,中國國民黨
高雄市左營區尾南里,-302,66,368,464,655,70.84,余建明,無
高雄市左營區尾西里,-382,98,480,695,918,75.71,郭錦彬,無
高雄市左營區屏山里,-363,118,481,948,1408,67.33,吳榮秀,中國國民黨
高雄市左營區崇實里,-113,491,604,447,666,67.12,吳武雄,無
高雄市左營區廍北里,-107,44,151,447,666,67.12,薛朝文,無
高雄市左營區廍南里,-231,45,276,447,666,67.12,陳美惠,無
高雄市左營區廟北里,-243,66,309,566,785,72.10,蘇進雄,無
高雄市左營區廟東里,-363,53,416,563,765,73.59,謝惠娟,無
高雄市左營區新上里,2840,3310,470,1116,1497,74.55,王櫻樺,中國國民黨
高雄市左營區新下里,1273,1921,648,1039,1407,73.85,黃慶德,中國國民黨
高雄市左營區新中里,-307,428,735,1141,1587,71.90,黃昱誌,無
高雄市左營區新光里,1240,1809,569,1190,1678,70.92,黃麗純,中國國民黨
高雄市左營區明建里,-143,156,299,443,643,68.90,顏靜玉,無
高雄市左營區果峰里,-560,125,685,447,666,67.12,曾瑞水,中國國民黨
高雄市左營區果惠里,-501,129,630,447,666,67.12,鄭夙雅,無
高雄市左營區果貿里,-199,265,464,447,666,67.12,韓得平,中國國民黨
高雄市左營區永清里,-57,171,228,443,643,68.90,郭鎮國,中國國民黨
高雄市左營區海勝里,-71,519,590,447,666,67.12,梁西榮,中國國民黨
高雄市左營區祥和里,-155,12,167,443,643,68.90,劉德文,中國國民黨
高雄市左營區福山里,4972,5276,304,1094,1474,74.22,葉德龍,中國國民黨
高雄市左營區聖南里,-261,53,314,447,666,67.12,陳勇利,無
高雄市左營區聖后里,-273,73,346,524,682,76.83,裴天成,無
高雄市左營區聖西里,-144,3,147,447,666,67.12,黃山本,無
高雄市左營區自助里,151,414,263,447,666,67.12,劉淯騰,民主進步黨
高雄市左營區莒光里,-316,149,465,443,643,68.90,柯麗枝,無
高雄市左營區菜公里,3612,4098,486,1073,1516,70.78,王振華,中國國民黨
高雄市左營區路東里,-293,60,353,447,666,67.12,黃秀綢,無
高雄市左營區進學里,-154,132,286,453,1669,27.14,曹順雄,無
高雄市左營區頂北里,-166,48,214,377,498,75.70,詹正國,無
高雄市左營區頂西里,-179,78,257,632,840,75.24,方秀娟,民主進步黨
高雄市彌陀區光和里,-624,125,749,882,1206,73.13,林清火,無
高雄市彌陀區南寮里,-101,226,327,847,1205,70.29,吳宏桂,無
高雄市彌陀區彌仁里,-205,35,240,350,503,69.58,梁天賞,無
高雄市彌陀區彌壽里,-367,79,446,576,749,76.90,吳義雄,無
高雄市彌陀區彌陀里,-122,212,334,656,864,75.93,林煌陸,無
高雄市彌陀區彌靖里,-171,178,349,633,882,71.77,吳志強,無
高雄市彌陀區文安里,-254,157,411,578,831,69.55,李泰山,無
高雄市彌陀區海尾里,-257,79,336,558,799,69.84,蘇政峯,無
高雄市彌陀區漯底里,-549,124,673,812,1093,74.29,孫萬賜,無
高雄市彌陀區舊港里,-175,174,349,528,729,72.43,李明山,無
高雄市彌陀區過港里,-428,105,533,619,883,70.10,張金長,無
高雄市彌陀區鹽埕里,-111,240,351,691,956,72.28,李允條,無
高雄市新興區中東里,-334,254,588,642,859,74.74,林明雄,無
高雄市新興區仁聲里,-310,117,427,654,977,66.94,蕭育霞,無
高雄市新興區光耀里,-59,259,318,782,1106,70.71,吳秀鈴,民主進步黨
高雄市新興區南港里,-314,179,493,642,859,74.74,陳福明,民主進步黨
高雄市新興區大明里,-391,92,483,642,859,74.74,徐慶宗,民主進步黨
高雄市新興區建興里,-275,106,381,642,859,74.74,薛富升,民主進步黨
高雄市新興區建華里,-299,94,393,642,859,74.74,吳文欽,無
高雄市新興區德政里,-278,74,352,438,586,74.74,謝國男,無
高雄市新興區德望里,-191,205,396,641,843,76.04,林郭麗玉,無
高雄市新興區德生里,-250,361,611,962,1332,72.22,吳三雄,民主進步黨
高雄市新興區愛平里,-308,133,441,642,859,74.74,高文龍,無
高雄市新興區成功里,-315,167,482,642,859,74.74,童健良,中國國民黨
高雄市新興區振成里,-206,99,305,677,968,69.94,陳敏夫,無
高雄市新興區振華里,-311,103,414,706,979,72.11,吳劍生,中國國民黨
高雄市新興區文昌里,33,361,328,1027,1388,73.99,劉育洋,中國國民黨
高雄市新興區新江里,-403,112,515,642,859,74.74,王金龍,無
高雄市新興區明莊里,-266,66,332,642,859,74.74,莊其章,無
高雄市新興區東坡里,-369,106,475,642,859,74.74,楊福順,民主進步黨
高雄市新興區榮治里,-259,78,337,642,859,74.74,許淑芬,無
高雄市新興區正氣里,-520,139,659,923,1259,73.31,沈玉玲,無
高雄市新興區永寧里,-288,170,458,959,1345,71.30,施澤民,民主進步黨
高雄市新興區浩然里,-246,194,440,540,769,70.22,張榮源,中國國民黨
高雄市新興區漢民里,-166,82,248,642,859,74.74,李賢宗,無
高雄市新興區玉衡里,-257,63,320,458,639,71.67,蔡瑞彬,無
高雄市新興區秋山里,-341,102,443,642,859,74.74,許吳瑞珍,無
高雄市新興區興昌里,-247,108,355,642,859,74.74,黃少嫻,無
高雄市新興區華聲里,-314,97,411,620,865,71.68,林禮志,無
高雄市新興區蕉園里,-162,84,246,506,675,74.96,鄭凱隆,無
高雄市新興區長驛里,-284,97,381,642,859,74.74,葉智陽,無
高雄市新興區開平里,-157,358,515,642,859,74.74,陳朝居,無
高雄市新興區順昌里,-32,270,302,747,1017,73.45,林朱堂,無
高雄市新興區黎明里,-273,71,344,642,859,74.74,許耀科,民主進步黨
高雄市旗山區三協里,-247,269,516,165,236,69.92,劉文寶,無
高雄市旗山區上洲里,-400,113,513,651,955,68.17,柯瑞斌,無
高雄市旗山區中寮里,-97,11,108,124,176,70.45,洪萬祥,無
高雄市旗山區中正里,3,131,128,671,1028,65.27,郭舜明,無
高雄市旗山區中洲里,-360,13,373,526,771,68.22,羅昱晴,無
高雄市旗山區南勝里,-279,151,430,630,889,70.87,廖宗吉,無
高雄市旗山區南洲里,-367,118,485,526,771,68.22,黃吉祥,無
高雄市旗山區圓富里,-56,184,240,722,1081,66.79,歐忠更,無
高雄市旗山區大山里,-283,129,412,817,1187,68.83,柯旗旺,無
高雄市旗山區大德里,-203,265,468,724,1042,69.48,曾慶義,無
高雄市旗山區大林里,-80,100,180,521,797,65.37,莊柏松,無
高雄市旗山區太平里,-127,223,350,774,1039,74.49,鄭明成,無
高雄市旗山區廣福里,-115,60,175,401,597,67.17,陳俊吉,無
高雄市旗山區新光里,-341,63,404,526,731,71.96,陳峯翔,無
高雄市旗山區東平里,-247,186,433,634,895,70.84,石正忠,無
高雄市旗山區東昌里,-417,97,514,662,960,68.96,邱清郎,無
高雄市旗山區永和里,62,341,279,747,1054,70.87,周銹玉,無
高雄市旗山區湄洲里,-98,165,263,558,820,68.05,陳聖允,民主進步黨
高雄市旗山區瑞吉里,-195,196,391,624,871,71.64,游俊樺,無
高雄市旗山區竹峰里,-61,168,229,587,835,70.30,郭信東,無
高雄市旗山區鯤洲里,-262,65,327,520,698,74.50,柯文化,民主進步黨
高雄市旗津區上竹里,-132,278,410,956,1508,63.40,陳仲智,無
高雄市旗津區中洲里,-61,157,218,956,1508,63.40,郭美伶,無
高雄市旗津區中興里,-192,259,451,956,1508,63.40,郭茂盛,無
高雄市旗津區中華里,-372,144,516,956,1508,63.40,徐漢仁,無
高雄市旗津區北汕里,-111,273,384,956,1508,63.40,林秀英,無
高雄市旗津區南汕里,-245,203,448,956,1508,63.40,蔡明議,無
高雄市旗津區安順里,-191,93,284,956,1508,63.40,莊武益,無
高雄市旗津區實踐里,-182,176,358,956,1508,63.40,楊台生,無
高雄市旗津區復興里,-539,130,669,857,1313,65.27,張順皇,無
高雄市旗津區慈愛里,-278,207,485,682,1096,62.23,夏啓峯,無
高雄市旗津區振興里,-604,158,762,994,1431,69.46,黃見益,無
高雄市旗津區旗下里,-291,124,415,750,1090,68.81,杜勝輝,無
高雄市旗津區永安里,-334,112,446,650,967,67.22,黃修和,無
高雄市杉林區上平里,-61,98,159,582,923,63.06,張福松,無
高雄市杉林區大愛里,-139,107,246,549,911,60.26,陳木源,無
高雄市杉林區新庄里,-176,96,272,566,941,60.15,陳勤招,無
高雄市杉林區月眉里,-66,156,222,628,960,65.42,官梅英,無
高雄市杉林區月美里,-360,83,443,751,1171,64.13,劉曉君,無
高雄市杉林區木梓里,-300,33,333,368,640,57.50,林同德,無
高雄市杉林區杉林里,-262,35,297,319,555,57.48,陳明昌,無
高雄市杉林區集來里,-323,70,393,427,714,59.80,楊正雄,無
高雄市林園區中厝里,-148,301,449,1036,1520,68.16,劉誌華,中國國民黨
高雄市林園區中汕里,-148,183,331,695,1029,67.54,黃國發,無
高雄市林園區中芸里,-70,162,232,681,970,70.21,謝樹來,無
高雄市林園區中門里,-332,270,602,797,1231,64.74,蘇信成,無
高雄市林園區五福里,-265,306,571,853,1293,65.97,洪月珍,無
高雄市林園區仁愛里,-354,313,667,1064,1434,74.20,呂繼承,無
高雄市林園區北汕里,-252,148,400,352,566,62.19,謝宿惠,無
高雄市林園區廣應里,-118,383,501,840,1195,70.29,陳玫玲,無
高雄市林園區文賢里,-275,305,580,958,1330,72.03,黃三源,無
高雄市林園區東林里,-108,312,420,905,1282,70.59,盧盈叡,無
高雄市林園區東汕里,-323,110,433,535,824,64.93,王福成,中國國民黨
高雄市林園區林內里,-64,222,286,721,1028,70.14,黃清景,無
高雄市林園區林園里,-111,327,438,758,1079,70.25,黃盟松,無
高雄市林園區林家里,-341,191,532,864,1261,68.52,林明田,無
高雄市林園區港嘴里,-897,159,1056,1139,1646,69.20,蔡明興,無
高雄市林園區港埔里,-179,210,389,631,890,70.90,吳石南,無
高雄市林園區溪州里,-186,522,708,943,1378,68.43,黃國輝,無
高雄市林園區潭頭里,-384,290,674,953,1340,71.12,劉建德,無
高雄市林園區王公里,-126,455,581,914,1441,63.43,洪進財,無
高雄市林園區西汕里,-328,32,360,453,702,64.53,邱鐘城,無
高雄市林園區西溪里,-326,339,665,706,1033,68.34,李文通,無
高雄市林園區頂厝里,-82,528,610,765,1138,67.22,陳碧對,無
高雄市林園區鳳芸里,-213,157,370,593,812,73.03,王泰山,無
高雄市林園區龔厝里,-391,146,537,733,1037,70.68,龔芳生,無
高雄市桃源區勤和里,-67,37,104,129,209,61.72,曾江清水,無
高雄市桃源區寶山里,-132,59,191,385,580,66.38,陳燕霜,無
高雄市桃源區建山里,-208,35,243,385,580,66.38,陳建億,無
高雄市桃源區復興里,-66,27,93,171,281,60.85,江孫財,無
高雄市桃源區拉芙蘭里,-80,31,111,138,228,60.53,謝貴奇,無
高雄市桃源區桃源里,-521,16,537,387,739,52.37,高慕源,無
高雄市桃源區梅山里,-116,18,134,182,263,69.20,顏忠義,無
高雄市桃源區高中里,-274,47,321,377,648,58.18,胡益明,無
高雄市梓官區中崙里,-379,121,500,817,1078,75.79,歐樹發,無
高雄市梓官區信蚵里,-250,273,523,588,887,66.29,曾盈豐,無
高雄市梓官區典寶里,-145,330,475,868,1189,73.00,洪文清,無
高雄市梓官區同安里,-264,197,461,683,950,71.89,蔣榮三,無
高雄市梓官區大舍里,8,347,339,950,1307,72.69,歐淼宗,無
高雄市梓官區智蚵里,74,362,288,679,978,69.43,鄭柏政,無
高雄市梓官區梓信里,-91,237,328,769,1022,75.24,蘇上火,無
高雄市梓官區梓和里,-264,217,481,603,806,74.81,姜志豪,無
高雄市梓官區梓平里,-276,172,448,1084,1406,77.10,黃常吉,無
高雄市梓官區梓義里,-60,237,297,718,997,72.02,余煊昱,無
高雄市梓官區禮蚵里,-211,150,361,711,1003,70.89,蔡添寳,無
高雄市梓官區茄苳里,-163,253,416,800,1097,72.93,劉和村,無
高雄市梓官區赤崁里,-169,173,342,753,1085,69.40,蔡良鑑,中國國民黨
高雄市梓官區赤東里,-47,224,271,905,1248,72.52,郭錦成,無
高雄市梓官區赤西里,-357,71,428,532,760,70.00,劉英凱,無
高雄市楠梓區中和里,513,918,405,1036,1510,68.61,楊亷政,無
高雄市楠梓區中興里,-523,365,888,1036,1510,68.61,黃朝吉,無
高雄市楠梓區中陽里,-104,437,541,735,1739,42.27,李添發,無
高雄市楠梓區久昌里,115,370,255,1035,1479,69.98,辜清桐,無
高雄市楠梓區五常里,428,886,458,954,1331,71.68,曾榮璋,無
高雄市楠梓區享平里,-16,408,424,674,972,69.34,陳顯能,無
高雄市楠梓區仁昌里,211,757,546,1036,1510,68.61,王永坤,中國國民黨
高雄市楠梓區加昌里,654,1050,396,875,1351,64.77,劉秀英,無
高雄市楠梓區和昌里,-102,193,295,645,881,73.21,周海玲,無
高雄市楠梓區國昌里,-35,289,324,1036,1510,68.61,王晟境,無
高雄市楠梓區大昌里,-150,239,389,698,962,72.56,戴嘉育,中國國民黨
高雄市楠梓區宏南里,-78,86,164,956,1355,70.55,張夢麒,無
高雄市楠梓區宏昌里,46,398,352,772,1101,70.12,劉秀桃,無
高雄市楠梓區宏榮里,-230,333,563,956,1355,70.55,陳宏榮,中國國民黨
高雄市楠梓區宏毅里,-335,252,587,956,1355,70.55,馮靖絨,無
高雄市楠梓區廣昌里,-142,292,434,1035,1391,74.41,蔡文東,無
高雄市楠梓區建昌里,-235,287,522,861,1196,71.99,曾讚義,中國國民黨
高雄市楠梓區惠楠里,-75,285,360,735,1739,42.27,張珮榕,無
高雄市楠梓區惠民里,383,660,277,735,1739,42.27,張淑分,無
高雄市楠梓區惠豐里,240,656,416,735,1739,42.27,黃意玲,無
高雄市楠梓區慶昌里,-65,326,391,774,1048,73.85,陳玉梅,中國國民黨
高雄市楠梓區東寧里,200,800,600,1003,1438,69.75,蘇吳錦秀,無
高雄市楠梓區泰昌里,-312,143,455,922,1311,70.33,鄭嘉平,無
高雄市楠梓區清豐里,2774,3183,409,802,1031,77.79,戴佑東,無
高雄市楠梓區玉屏里,-151,228,379,956,1355,70.55,洪千雅,無
高雄市楠梓區瑞屏里,-184,401,585,956,1355,70.55,郭進和,無
高雄市楠梓區盛昌里,358,693,335,955,1264,75.55,杜炎明,無
高雄市楠梓區福昌里,-392,231,623,684,898,76.17,張育綺,無
高雄市楠梓區秀昌里,-44,230,274,875,1351,64.77,張明全,中國國民黨
高雄市楠梓區稔田里,-190,176,366,956,1355,70.55,陳瑞輅,無
高雄市楠梓區翠屏里,1823,2239,416,956,1355,70.55,吳永晨,無
高雄市楠梓區興昌里,244,552,308,569,773,73.61,謝騏襄,無
高雄市楠梓區藍田里,1253,1605,352,1036,1510,68.61,謝坤易,民主進步黨
高雄市楠梓區裕昌里,347,658,311,815,1143,71.30,郭明勲,無
高雄市楠梓區金田里,176,606,430,956,1355,70.55,邱世宗,無
高雄市楠梓區錦屏里,-162,200,362,956,1355,70.55,蔡甲庚,無
高雄市楠梓區隆昌里,91,300,209,875,1351,64.77,蔡淑貞,中國國民黨
高雄市橋頭區三德里,-223,70,293,585,756,77.38,劉崇凱,無
高雄市橋頭區中崎里,-297,70,367,469,627,74.80,蘇招治,無
高雄市橋頭區仕和里,-139,453,592,921,1214,75.86,朱高成,無
高雄市橋頭區仕豐里,-131,361,492,986,1302,75.73,周才淵,民主進步黨
高雄市橋頭區仕隆里,-159,228,387,845,1127,74.98,馬兆賢,無
高雄市橋頭區德松里,-12,199,211,662,838,79.00,何東喜,民主進步黨
高雄市橋頭區新莊里,942,1187,245,733,987,74.27,朱正清,無
高雄市橋頭區東林里,-334,261,595,734,970,75.67,陸見青,無
高雄市橋頭區橋南里,-422,168,590,707,926,76.35,蘇道明,無
高雄市橋頭區橋頭里,-148,208,356,707,926,76.35,余美蓮,無
高雄市橋頭區甲北里,-66,340,406,816,1071,76.19,李林足素,無
高雄市橋頭區甲南里,-380,271,651,863,1188,72.64,方明賢,無
高雄市橋頭區白樹里,181,412,231,875,1229,71.20,吳安祥,無
高雄市橋頭區筆秀里,-146,159,305,664,875,75.89,李庭珮,無
高雄市橋頭區芋寮里,-199,132,331,869,1137,76.43,傅壽勝,無
高雄市橋頭區西林里,-321,128,449,496,644,77.02,吳建豐,無
高雄市橋頭區頂鹽里,-375,218,593,816,1071,76.19,顏家進,無
高雄市永安區保寧里,-24,373,397,940,1310,71.76,陳文印,無
高雄市永安區新港里,29,308,279,561,776,72.29,蘇月鳳,無
高雄市永安區永安里,-201,136,337,561,776,72.29,林水雹,無
高雄市永安區永華里,-168,205,373,648,878,73.80,林明春,無
高雄市永安區維新里,96,458,362,797,1105,72.13,蔣福山,無
高雄市永安區鹽田里,-161,33,194,278,401,69.33,柯男烈,無
高雄市湖內區中賢里,-87,308,395,895,1203,74.40,王阮寶雲,無
高雄市湖內區公舘里,-46,327,373,834,1098,75.96,林蘇麗雲,無
高雄市湖內區劉家里,-189,135,324,734,1037,70.78,劉宏添,無
高雄市湖內區大湖里,168,447,279,649,893,72.68,洪添謀,無
高雄市湖內區太爺里,-235,82,317,561,746,75.20,蘇宗傑,無
高雄市湖內區忠興里,-232,125,357,767,1105,69.41,邱韋能,無
高雄市湖內區文賢里,-322,71,393,895,1203,74.40,林金坤,無
高雄市湖內區海埔里,-83,210,293,650,874,74.37,杜丙戍,無
高雄市湖內區海山里,-511,47,558,734,1037,70.78,劉寶霞,無
高雄市湖內區湖內里,91,530,439,573,772,74.22,林志聰,無
高雄市湖內區湖東里,57,347,290,638,898,71.05,黃太平,無
高雄市湖內區田尾里,-347,167,514,649,893,72.68,謝秋影,無
高雄市湖內區葉厝里,-39,320,359,607,870,69.77,葉進昌,無
高雄市湖內區逸賢里,-440,71,511,767,1105,69.41,林秀卿,無
高雄市燕巢區南燕里,6,468,462,782,1076,72.68,龔榮源,無
高雄市燕巢區安招里,308,361,53,725,973,74.51,黃清吉,中國國民黨
高雄市燕巢區尖山里,-455,93,548,767,1105,69.41,何旭信,無
高雄市燕巢區東燕里,-268,265,533,814,1133,71.84,吳振武,無
高雄市燕巢區橫山里,-122,185,307,524,720,72.78,陳隆盛,無
高雄市燕巢區深水里,-206,206,412,922,1373,67.15,林明雄,無
高雄市燕巢區瓊林里,-265,263,528,786,1102,71.32,張舜傑,無
高雄市燕巢區西燕里,-119,431,550,655,920,71.20,李秀英,無
高雄市燕巢區角宿里,-89,352,441,679,883,76.90,莊璨隆,無
高雄市燕巢區金山里,-123,41,164,299,425,70.35,林順輔,無
高雄市燕巢區鳳雄里,-424,247,671,705,1024,68.85,陳明發,無
高雄市田寮區七星里,-274,38,312,395,585,67.52,呂革明,無
高雄市田寮區三和里,-158,24,182,188,318,59.12,林正春,無
高雄市田寮區南安里,-82,71,153,364,587,62.01,葉正諒,無
高雄市田寮區古亭里,-184,23,207,305,454,67.18,許英豪,無
高雄市田寮區大同里,-159,24,183,217,351,61.82,王榮華,無
高雄市田寮區崇德里,-384,105,489,640,885,72.32,陳金城,無
高雄市田寮區新興里,-199,91,290,390,555,70.27,何百農,無
高雄市田寮區田寮里,-179,11,190,223,343,65.01,連于萱,無
高雄市田寮區西德里,-355,57,412,485,729,66.53,黃萬春,無
高雄市田寮區鹿埔里,-165,17,182,242,342,70.76,楊美芬,無
高雄市甲仙區和安里,-292,43,335,399,639,62.44,李新福,中國國民黨
高雄市甲仙區大田里,-210,109,319,428,720,59.44,張琪,無
高雄市甲仙區寶隆里,-300,34,334,370,616,60.06,連英朱,無
高雄市甲仙區小林里,-173,36,209,281,488,57.58,潘世彬,無
高雄市甲仙區東安里,-123,48,171,225,420,53.57,游新儀,中國國民黨
高雄市甲仙區西安里,-436,67,503,570,826,69.01,范姮枝,中國國民黨
高雄市甲仙區關山里,-280,29,309,373,560,66.61,林欣郿,無
高雄市美濃區中圳里,-144,205,349,698,1038,67.24,黃其添,無
高雄市美濃區中壇里,-212,146,358,605,934,64.78,楊秋田,無
高雄市美濃區合和里,-122,171,293,460,754,61.01,林作松,無
高雄市美濃區吉和里,-151,144,295,415,605,68.60,黃文梅,無
高雄市美濃區吉東里,-181,166,347,567,839,67.58,黃新華,無
高雄市美濃區吉洋里,-156,140,296,578,884,65.38,曾順昌,無
高雄市美濃區廣德里,-262,154,416,793,1230,64.47,黃沛文,無
高雄市美濃區廣林里,-191,101,292,863,1365,63.22,傅兆鎮,無
高雄市美濃區德興里,-248,135,383,970,1392,69.68,黃建雄,無
高雄市美濃區東門里,-184,120,304,727,1112,65.38,羅文俊,無
高雄市美濃區泰安里,-100,192,292,455,682,66.72,邱國維,無
高雄市美濃區清水里,-174,145,319,610,904,67.48,張金發,無
高雄市美濃區瀰濃里,-29,202,231,789,1261,62.57,林仁興,無
高雄市美濃區獅山里,-331,187,518,926,1370,67.59,鍾明福,無
高雄市美濃區祿興里,-162,307,469,813,1251,64.99,劉昭宏,無
高雄市美濃區福安里,49,207,158,755,1104,68.39,鍾銘安,無
高雄市美濃區興隆里,-355,45,400,716,1085,65.99,黃耀榮,無
高雄市美濃區龍山里,-390,160,550,684,1029,66.47,温源興,無
高雄市美濃區龍肚里,-169,90,259,425,605,70.25,邱連發,無
高雄市苓雅區中正里,-80,347,427,518,742,69.81,胡維成,中國國民黨
高雄市苓雅區五權里,-126,248,374,853,1121,76.09,陳玉環,無
高雄市苓雅區五福里,-63,347,410,828,1125,73.60,邱瑞祥,民主進步黨
高雄市苓雅區人和里,-218,175,393,518,742,69.81,林志田,民主進步黨
高雄市苓雅區仁政里,-511,125,636,518,742,69.81,黃裕庭,無
高雄市苓雅區光華里,-297,62,359,518,742,69.81,吳照鉠,民主進步黨
高雄市苓雅區凱旋里,-285,253,538,518,742,69.81,錢雲徽,中國國民黨
高雄市苓雅區博仁里,-239,64,303,445,618,72.01,陳奇伯,中國國民黨
高雄市苓雅區同慶里,-196,269,465,518,742,69.81,高文明,無
高雄市苓雅區和煦里,-216,227,443,518,742,69.81,莊財通,無
高雄市苓雅區城北里,-20,192,212,558,789,70.72,王宏嘉,無
高雄市苓雅區城東里,-65,221,286,518,742,69.81,史妮可,無
高雄市苓雅區城西里,-248,2,250,518,742,69.81,朱育賢,無
高雄市苓雅區奏捷里,-147,183,330,512,669,76.53,林豐富,民主進步黨
高雄市苓雅區安祥里,-88,321,409,958,1320,72.58,董輝章,中國國民黨
高雄市苓雅區尚義里,-190,167,357,518,742,69.81,曾蔡玉燕,中國國民黨
高雄市苓雅區廣澤里,-145,181,326,518,742,69.81,沈秀美,無
高雄市苓雅區建軍里,-170,141,311,688,976,70.49,黄錫聰,無
高雄市苓雅區意誠里,-17,388,405,518,742,69.81,蕭長保,中國國民黨
高雄市苓雅區文昌里,-25,384,409,846,1124,75.27,林博文,民主進步黨
高雄市苓雅區日中里,-20,220,240,518,742,69.81,許愛珠,無
高雄市苓雅區普天里,114,413,299,518,742,69.81,李文豪,無
高雄市苓雅區普照里,22,298,276,518,742,69.81,蔡政宏,無
高雄市苓雅區晴朗里,101,251,150,518,742,69.81,孫永吉,無
高雄市苓雅區朝陽里,-22,147,169,487,690,70.58,丁文瑞,無
高雄市苓雅區林中里,-92,282,374,518,742,69.81,杜佳福,無
高雄市苓雅區林南里,-142,273,415,518,742,69.81,黃旭煌,無
高雄市苓雅區林圍里,-49,291,340,518,742,69.81,羅莉萍,中國國民黨
高雄市苓雅區林安里,-131,198,329,518,742,69.81,張列綱,無
高雄市苓雅區林富里,-176,295,471,518,742,69.81,林進安,無
高雄市苓雅區林德里,-159,211,370,518,742,69.81,翁正財,無
高雄市苓雅區林榮里,-23,485,508,518,742,69.81,王文祿,無
高雄市苓雅區林泉里,-153,205,358,518,742,69.81,翁烔訓,中國國民黨
高雄市苓雅區林興里,-155,120,275,518,742,69.81,黃培裕,民主進步黨
高雄市苓雅區林華里,22,258,236,518,742,69.81,張家偉,民主進步黨
高雄市苓雅區林西里,-127,147,274,518,742,69.81,方琪麟,中國國民黨
高雄市苓雅區林貴里,-48,211,259,518,742,69.81,黃清溪,無
高雄市苓雅區林靖里,-65,173,238,601,816,73.65,蔡温怡,無
高雄市苓雅區正仁里,-45,321,366,735,1047,70.20,黃敏捷,無
高雄市苓雅區正大里,139,595,456,735,1047,70.20,陳錦宏,無
高雄市苓雅區正心里,13,394,381,834,1094,76.23,陳顏秋萍,中國國民黨
高雄市苓雅區正文里,-249,324,573,897,1193,75.19,莊文忠,無
高雄市苓雅區正義里,-332,266,598,735,1047,70.20,劉銀連,中國國民黨
高雄市苓雅區正言里,-164,223,387,601,840,71.55,古金川,無
高雄市苓雅區正道里,-144,462,606,913,1316,69.38,楊舜堡,無
高雄市苓雅區民主里,22,493,471,739,991,74.57,陳文程,無
高雄市苓雅區永康里,-10,252,262,776,1015,76.45,陳瑛定,無
高雄市苓雅區田西里,-396,163,559,518,742,69.81,郭國民,中國國民黨
高雄市苓雅區福人里,-48,196,244,711,1000,71.10,曾黃金華,無
高雄市苓雅區福南里,-96,172,268,583,795,73.33,蘇文安,無
高雄市苓雅區福地里,-84,262,346,826,1171,70.54,蔡添財,無
高雄市苓雅區福壽里,-184,154,338,475,668,71.11,郭寬洲,民主進步黨
高雄市苓雅區福居里,-221,245,466,830,1213,68.43,吳明憲,民主進步黨
高雄市苓雅區福康里,-94,191,285,598,834,71.70,陳信吾,無
高雄市苓雅區福東里,-220,284,504,802,1110,72.25,劉呂燕芬,無
高雄市苓雅區福海里,-354,125,479,698,957,72.94,廖富男,中國國民黨
高雄市苓雅區福祥里,-411,168,579,861,1189,72.41,劉榮福,民主進步黨
高雄市苓雅區福西里,-273,185,458,635,874,72.65,黃正德,無
高雄市苓雅區福隆里,-265,309,574,957,1354,70.68,郭彌堅,民主進步黨
高雄市苓雅區美田里,-391,120,511,518,742,69.81,吳金對,無
高雄市苓雅區苓中里,-88,193,281,552,736,75.00,吳敏寬,無
高雄市苓雅區苓昇里,-228,120,348,779,1104,70.56,陳文喜,無
高雄市苓雅區苓東里,-58,136,194,482,702,68.66,楊玉鳳,無
高雄市苓雅區苓洲里,-87,169,256,567,816,69.49,吳弘宜,中國國民黨
高雄市苓雅區苓雅里,-63,151,214,482,677,71.20,郭釗琦,無
高雄市苓雅區英明里,-207,190,397,518,742,69.81,黃秀靜,無
高雄市苓雅區華堂里,-118,299,417,518,742,69.81,曾興德,無
高雄市苓雅區衛武里,-220,199,419,735,1047,70.20,邱秀迷,無
高雄市苓雅區鼓中里,-400,82,482,518,742,69.81,郭明鴻,無
高雄市茂林區多納里,-220,47,267,351,490,71.63,羅耀明,中國國民黨
高雄市茂林區茂林里,-236,88,324,532,711,74.82,"田振弘 Kukui‧Pakadavy",中國國民黨
高雄市茂林區萬山里,-298,24,322,277,361,76.73,蔡正男,無
高雄市茄萣區保定里,-457,264,721,660,937,70.44,郭淑芬,無
高雄市茄萣區光定里,-185,90,275,575,871,66.02,林高華,無
高雄市茄萣區吉定里,-374,129,503,794,1088,72.98,薛賢成,無
高雄市茄萣區和協里,-404,122,526,586,913,64.18,吳進發,無
高雄市茄萣區嘉安里,-270,107,377,586,913,64.18,林陳麗雯,無
高雄市茄萣區嘉定里,-248,130,378,701,1028,68.19,歐清信,無
高雄市茄萣區嘉樂里,-285,223,508,586,913,64.18,郭松南,無
高雄市茄萣區嘉泰里,-278,115,393,586,913,64.18,鄭君男,無
高雄市茄萣區嘉福里,-229,125,354,586,913,64.18,吳財榮,無
高雄市茄萣區嘉賜里,-145,449,594,759,1198,63.36,葉宏信,民主進步黨
高雄市茄萣區大定里,-260,145,405,637,904,70.46,薛金成,無
高雄市茄萣區崎漏里,55,530,475,686,1022,67.12,邱美麗,無
高雄市茄萣區白雲里,-86,168,254,659,880,74.89,郭麗華,無
高雄市茄萣區福德里,-230,142,372,666,906,73.51,陳茂生,無
高雄市茄萣區萬福里,-379,86,465,560,825,67.88,蘇永南,無
高雄市路竹區三爺里,-304,134,438,595,788,75.51,康庭琰,無
高雄市路竹區下坑里,-37,299,336,615,827,74.37,王金水,無
高雄市路竹區北嶺里,-321,161,482,891,1168,76.28,黃松德,無
高雄市路竹區後鄉里,-328,244,572,794,1046,75.91,金宜頵,無
高雄市路竹區文北里,110,429,319,714,936,76.28,陳慶宗,無
高雄市路竹區文南里,-185,244,429,849,1144,74.21,許明嘉,無
高雄市路竹區新達里,-180,203,383,694,972,71.40,杜明昌,無
高雄市路竹區甲北里,3,377,374,651,899,72.41,王錦祥,無
高雄市路竹區甲南里,-80,325,405,717,1003,71.49,黃吉松,無
高雄市路竹區社中里,-267,97,364,551,801,68.79,魏林寶菊,無
高雄市路竹區社南里,219,483,264,662,866,76.44,石永昌,中國國民黨
高雄市路竹區社東里,-87,285,372,795,1069,74.37,蘇鑫,無
高雄市路竹區社西里,-303,227,530,768,1079,71.18,馬旭來,無
高雄市路竹區竹南里,42,303,261,635,872,72.82,高月英,無
高雄市路竹區竹園里,-185,291,476,615,827,74.37,辛瑞賢,無
高雄市路竹區竹東里,57,482,425,672,899,74.75,程啓龍,無
高雄市路竹區竹滬里,-54,362,416,694,972,71.40,劉崑芳,無
高雄市路竹區竹西里,-243,264,507,684,965,70.88,黃李月施,無
高雄市路竹區頂寮里,-292,176,468,694,972,71.40,黃居賢,無
高雄市路竹區鴨寮里,-263,169,432,753,979,76.92,蘇清吉,無
高雄市那瑪夏區南沙魯里,-181,25,206,336,466,72.10,劉陳玉梅,無
高雄市那瑪夏區瑪雅里,-274,56,330,422,623,67.74,許利滿,無
高雄市那瑪夏區達卡努瓦里,-350,91,441,373,742,50.27,朱子亮,無
高雄市阿蓮區中路里,-201,183,384,688,983,69.99,林永信,無
高雄市阿蓮區南蓮里,8,377,369,748,1042,71.79,林首相,無
高雄市阿蓮區和蓮里,-370,216,586,724,1004,72.11,陳秀裡,無
高雄市阿蓮區峯山里,-573,111,684,831,1167,71.21,鄭鴻哖,無
高雄市阿蓮區崗山里,-375,85,460,523,749,69.83,吳尚儒,無
高雄市阿蓮區復安里,-261,115,376,577,808,71.41,何榮華,中國國民黨
高雄市阿蓮區清蓮里,35,281,246,595,876,67.92,陳伯温,無
高雄市阿蓮區港後里,96,295,199,487,661,73.68,鄭文能,無
高雄市阿蓮區玉庫里,-441,133,574,523,749,69.83,鄭明聰,無
高雄市阿蓮區石安里,-373,172,545,892,1232,72.40,蔡寬意,無
高雄市阿蓮區阿蓮里,58,564,506,820,1167,70.27,黃靖娟,無
高雄市阿蓮區青旗里,-214,134,348,511,759,67.33,陳文曉,無
高雄市鳥松區仁美里,398,754,356,943,1289,73.16,吳家儒,無
高雄市鳥松區坔埔里,-35,431,466,876,1174,74.62,黃永順,民主進步黨
高雄市鳥松區夢裡里,124,669,545,1012,1357,74.58,陳萬丁,無
高雄市鳥松區大竹里,-350,20,370,534,735,72.65,蔡榮瑞,無
高雄市鳥松區大華里,891,1267,376,1012,1357,74.58,蔡美蘭,中國國民黨
高雄市鳥松區華美里,52,448,396,534,735,72.65,邱宏棋,無
高雄市鳥松區鳥松里,841,1155,314,1012,1357,74.58,謝唐欽,無
高雄市鳳山區一甲里,11,354,343,960,1297,74.02,蔡瑋誠,無
高雄市鳳山區三民里,-435,140,575,546,839,65.08,黃榮貴,無
高雄市鳳山區中和里,-50,394,444,546,839,65.08,張簡進興,無
高雄市鳳山區中崙里,-193,214,407,873,1229,71.03,林齊諒,無
高雄市鳳山區中榮里,-40,562,602,988,1417,69.72,劉秀美,無
高雄市鳳山區中正里,-71,462,533,917,1252,73.24,鄒家駿,中國國民黨
高雄市鳳山區中民里,-1,560,561,1040,1422,73.14,黃金利,無
高雄市鳳山區二甲里,123,600,477,960,1297,74.02,黃昭雄,無
高雄市鳳山區五福里,-281,236,517,1084,1473,73.59,王劉煌,無
高雄市鳳山區保安里,572,992,420,960,1297,74.02,謝昆政,無
高雄市鳳山區光明里,-453,154,607,546,839,65.08,王俊富,無
高雄市鳳山區北門里,-112,436,548,1017,1371,74.18,謝秀霞,民主進步黨
高雄市鳳山區協和里,-131,384,515,546,839,65.08,羅美滿,無
高雄市鳳山區南和里,-131,302,433,767,1054,72.77,李錦珠,民主進步黨
高雄市鳳山區南成里,781,1355,574,1050,1450,72.41,楊居財,無
高雄市鳳山區南興里,-344,100,444,546,839,65.08,廖春花,無
高雄市鳳山區和德里,-155,454,609,546,839,65.08,吳金池,無
高雄市鳳山區和興里,124,549,425,546,839,65.08,周春生,無
高雄市鳳山區善美里,372,720,348,864,1265,68.30,張育臺,民主進步黨
高雄市鳳山區國光里,-267,252,519,750,1026,73.10,呂岳霖,無
高雄市鳳山區國富里,-51,352,403,769,1048,73.38,陳振沛,無
高雄市鳳山區國泰里,11,374,363,780,1111,70.21,黃昭清,無
高雄市鳳山區國隆里,-282,240,522,769,1048,73.38,呂富貴,無
高雄市鳳山區埤頂里,25,696,671,1064,1442,73.79,謝順和,無
高雄市鳳山區大德里,11,508,497,949,1343,70.66,侯俊傑,無
高雄市鳳山區天興里,48,398,350,761,1044,72.89,郭秉鑫,無
高雄市鳳山區富榮里,-181,228,409,767,1054,72.77,郭登臨,無
高雄市鳳山區富甲里,-89,237,326,668,959,69.66,王筱銜,無
高雄市鳳山區忠孝里,196,603,407,808,1167,69.24,蔡美雪,無
高雄市鳳山區忠義里,48,615,567,647,866,74.71,李朝清,無
高雄市鳳山區忠誠里,-290,476,766,1207,1717,70.30,陳永壽,無
高雄市鳳山區成功里,-301,18,319,489,677,72.23,鄭美玉,無
高雄市鳳山區文山里,338,813,475,879,1225,71.76,黃惠玲,民主進步黨
高雄市鳳山區文德里,555,1195,640,990,1384,71.53,謝智華,無
高雄市鳳山區文福里,715,1405,690,1296,1740,74.48,余世善,無
高雄市鳳山區文英里,14,484,470,919,1225,75.02,鄭鴻章,無
高雄市鳳山區文華里,317,1006,689,1053,1500,70.20,張嘉玲,無
高雄市鳳山區文衡里,179,573,394,897,1273,70.46,洪啟修,無
高雄市鳳山區新富里,59,491,432,887,1238,71.65,李金福,無
高雄市鳳山區新強里,194,581,387,1007,1363,73.88,李得勝,民主進步黨
高雄市鳳山區新樂里,-196,461,657,933,1389,67.17,李滋宏,民主進步黨
高雄市鳳山區新武里,106,386,280,943,1219,77.36,李戊琳,無
高雄市鳳山區新泰里,213,594,381,961,1289,74.55,歐諺霖,無
高雄市鳳山區新甲里,-202,422,624,1082,1442,75.03,柯寶凱,無
高雄市鳳山區新興里,-15,184,199,546,839,65.08,郭傅美金,無
高雄市鳳山區曹公里,28,221,193,642,842,76.25,曾齡瑩,無
高雄市鳳山區東門里,323,713,390,868,1313,66.11,劉晋祥,無
高雄市鳳山區正義里,108,588,480,946,1338,70.70,鄭洂汯,無
高雄市鳳山區武慶里,7,349,342,772,1031,74.88,張淑敏,無
高雄市鳳山區武松里,-74,305,379,990,1363,72.63,戴惠敏,無
高雄市鳳山區武漢里,-85,487,572,652,941,69.29,蘇弘展,民主進步黨
高雄市鳳山區海光里,-115,344,459,546,839,65.08,鍾翠民,無
高雄市鳳山區海洋里,-14,520,534,887,1238,71.65,蔡秀寶,無
高雄市鳳山區瑞竹里,-22,572,594,546,839,65.08,李美雲,中國國民黨
高雄市鳳山區瑞興里,-95,693,788,1011,1387,72.89,王玉蘭,中國國民黨
高雄市鳳山區生明里,-259,218,477,546,839,65.08,郭清竹,中國國民黨
高雄市鳳山區福祥里,-51,350,401,1059,1458,72.63,李安琪,無
高雄市鳳山區福興里,192,461,269,962,1368,70.32,鄭陳麗珠,無
高雄市鳳山區福誠里,120,727,607,1059,1458,72.63,許德發,民主進步黨
高雄市鳳山區縣口里,-187,4,191,546,839,65.08,洪敏川,無
高雄市鳳山區縣衙里,-303,104,407,560,768,72.92,王鈴雅,中國國民黨
高雄市鳳山區老爺里,469,812,343,878,1248,70.35,李菁雅,無
高雄市鳳山區興中里,-310,137,447,546,839,65.08,林天財,中國國民黨
高雄市鳳山區興仁里,-131,386,517,546,839,65.08,林曾桂花,無
高雄市鳳山區誠信里,-320,154,474,678,951,71.29,蔡自謄,中國國民黨
高雄市鳳山區誠德里,-69,324,393,546,839,65.08,陳世寳,中國國民黨
高雄市鳳山區誠智里,-126,309,435,826,1209,68.32,黃桂花,中國國民黨
高雄市鳳山區誠義里,-53,549,602,546,839,65.08,劉啓芳,中國國民黨
高雄市鳳山區過埤里,1734,2148,414,1078,1528,70.55,莫尚忠,無
高雄市鳳山區鎮北里,971,1651,680,1098,1523,72.09,趙志成,無
高雄市鳳山區鎮南里,101,480,379,901,1229,73.31,楊三吉,民主進步黨
高雄市鳳山區鎮東里,-207,339,546,546,839,65.08,張簡裕芳,無
高雄市鳳山區鎮西里,334,594,260,826,1105,74.75,李陳金治,無
高雄市鳳山區鳳崗里,-420,128,548,726,981,74.01,董錦慧,中國國民黨
高雄市鳳山區鳳東里,299,800,501,1203,1627,73.94,蔡瑋寧,民主進步黨
高雄市鳳山區龍成里,-224,297,521,946,1326,71.34,張芳瑋,無
高雄市鹽埕區中原里,-129,55,184,396,522,75.86,洪玄志,無
高雄市鹽埕區中山里,-429,156,585,904,1253,72.15,易明忠,無
高雄市鹽埕區光明里,-469,6,475,920,1473,62.46,葛吉雄,無
高雄市鹽埕區南端里,-315,92,407,920,1473,62.46,陳清標,無
高雄市鹽埕區博愛里,-217,45,262,438,587,74.62,林哲弘,無
高雄市鹽埕區壽星里,-234,115,349,828,1216,68.09,黃強,無
高雄市鹽埕區府北里,-10,200,210,920,1473,62.46,莊世權,無
高雄市鹽埕區慈愛里,-132,34,166,218,302,72.19,呂佳穎,無
高雄市鹽埕區教仁里,-147,202,349,625,820,76.22,高陳文玲,無
高雄市鹽埕區新化里,-239,65,304,920,1473,62.46,夏麗鳳,無
高雄市鹽埕區新樂里,-207,88,295,583,763,76.41,黃昭翔,無
高雄市鹽埕區新豐里,-216,86,302,920,1473,62.46,郭蘇元,無
高雄市鹽埕區江南里,-201,44,245,920,1473,62.46,蔡德龍,民主進步黨
高雄市鹽埕區江西里,-414,99,513,920,1473,62.46,鄭錫國,無
高雄市鹽埕區沙地里,-243,67,310,920,1473,62.46,高健財,無
高雄市鹽埕區河濱里,-147,190,337,920,1473,62.46,林德松,無
高雄市鹽埕區港都里,-345,81,426,920,1473,62.46,邱誌雲,民主進步黨
高雄市鹽埕區瀨南里,-151,49,200,920,1473,62.46,邱有洧,無
高雄市鹽埕區育仁里,-278,65,343,920,1473,62.46,葛有力,無
高雄市鹽埕區藍橋里,-258,166,424,911,1211,75.23,陳本興,中國國民黨
高雄市鹽埕區陸橋里,-362,111,473,920,1473,62.46,許梅娟,民主進步黨
高雄市鼓山區光化里,-323,122,445,827,1171,70.62,周國城,無
高雄市鼓山區光榮里,66,375,309,683,952,71.74,葉文朗,無
高雄市鼓山區內惟里,-342,136,478,709,985,71.98,林進發,無
高雄市鼓山區前峰里,-64,430,494,836,1154,72.44,盧明惠,中國國民黨
高雄市鼓山區厚生里,-334,342,676,906,1189,76.20,歐瑞清,無
高雄市鼓山區哨船頭里,-221,100,321,795,1154,68.89,楊宗正,無
高雄市鼓山區壽山里,-427,121,548,795,1154,68.89,陳進興,民主進步黨
高雄市鼓山區寶樹里,-369,111,480,789,1880,41.97,王登科,無
高雄市鼓山區山下里,-347,143,490,910,1224,74.35,杜文瑞,中國國民黨
高雄市鼓山區峰南里,-370,52,422,795,1154,68.89,王宋金花,中國國民黨
高雄市鼓山區平和里,-314,356,670,1173,1608,72.95,陳玉芳,民主進步黨
高雄市鼓山區延平里,-250,71,321,795,1154,68.89,洪蔡愛玉,無
高雄市鼓山區建國里,0,287,287,873,1116,78.23,林福祥,無
高雄市鼓山區忠正里,-163,392,555,844,1169,72.20,洪吉祥,無
高雄市鼓山區惠安里,-367,122,489,795,1154,68.89,洪進成,無
高雄市鼓山區新民里,-354,92,446,795,1154,68.89,洪宗郁,無
高雄市鼓山區明誠里,1645,2085,440,1177,1641,71.72,胡景森,中國國民黨
高雄市鼓山區桃源里,-179,53,232,795,1154,68.89,李慶賢,無
高雄市鼓山區樹德里,-437,110,547,810,1059,76.49,黃武田,無
高雄市鼓山區正德里,-680,192,872,1348,1843,73.14,朱榮俊,中國國民黨
高雄市鼓山區民強里,-203,242,445,875,1178,74.28,歐華美,無
高雄市鼓山區民族里,-587,155,742,939,1209,77.67,朱春木,中國國民黨
高雄市鼓山區河邊里,-378,6,384,795,1154,68.89,曾茂信,中國國民黨
高雄市鼓山區登山里,-295,64,359,795,1154,68.89,許永堃,無
高雄市鼓山區綠川里,-388,130,518,795,1154,68.89,郭國華,無
高雄市鼓山區維生里,-447,109,556,795,1154,68.89,董錦昌,無
高雄市鼓山區自強里,-276,63,339,468,658,71.12,方紹義,中國國民黨
高雄市鼓山區興宗里,-520,100,620,833,1178,70.71,楊孟翰,無
高雄市鼓山區華豐里,-75,485,560,1246,1728,72.11,黃明洲,中國國民黨
高雄市鼓山區裕興里,-87,418,505,1246,1728,72.11,曾榮發,中國國民黨
高雄市鼓山區裕豐里,-375,313,688,1246,1728,72.11,周恆功,中國國民黨
高雄市鼓山區雄峰里,-9,247,256,544,837,64.99,楊惠茵,中國國民黨
高雄市鼓山區麗興里,-306,85,391,795,1154,68.89,王志斌,無
高雄市鼓山區鼓岩里,-357,100,457,735,1089,67.49,方國智,無
高雄市鼓山區鼓峰里,-197,253,450,638,925,68.97,麥克士,中國國民黨
高雄市鼓山區龍井里,-302,116,418,813,1136,71.57,周明吉,無
高雄市鼓山區龍子里,1900,2227,327,1024,1377,74.36,蘇彥傑,無
高雄市鼓山區龍水里,2731,3308,577,1300,1808,71.90,初學霖,民主進步黨
