村里,2024-2022,2024民眾黨,2022村里長得票,2024投票數,2024選舉人數,2024投票率,里長姓名,里長政黨
高雄市三民區力行里,-261,109,370,787,1000,0.8,李水池,中國國民黨
高雄市三民區十全里,-748,190,938,1205,1618,0.7,洪能通,無
高雄市三民區十美里,-168,89,257,654,877,0.7,蔡灯能,民主進步黨
高雄市三民區千北里,-393,98,491,733,974,0.8,黃林麗香,無
高雄市三民區千歲里,-467,113,580,802,1081,0.7,許婉羚,無
高雄市三民區千秋里,-384,172,556,1318,1893,0.7,蔡文和,無
高雄市三民區博惠里,-351,382,733,2753,3777,0.7,洪耀斌,無
高雄市三民區博愛里,-482,137,619,811,1113,0.7,鍾秋美,無
高雄市三民區同德里,-119,264,383,1915,2538,0.8,陳清源,無
高雄市三民區安吉里,-246,608,854,3274,4558,0.7,王明文,無
高雄市三民區安和里,-397,300,697,1839,2436,0.8,傅秋陽,民主進步黨
高雄市三民區安宜里,-615,334,949,2254,2957,0.8,周黃俊宇,無
高雄市三民區安寧里,-213,169,382,1189,1771,0.7,郭海定,民主進步黨
高雄市三民區安康里,-331,150,481,936,1445,0.6,孫聖雄,無
高雄市三民區安東里,-483,391,874,2285,2986,0.8,林添祥,無
高雄市三民區安泰里,-277,403,680,2565,3547,0.7,謝明學,無
高雄市三民區安生里,-724,211,935,1207,1621,0.7,余許淑女,無
高雄市三民區安發里,45,486,441,3001,4203,0.7,蔡明德,無
高雄市三民區安邦里,43,452,409,2675,3600,0.7,黃崑山,無
高雄市三民區寶中里,-79,320,399,2009,2752,0.7,任憲慶,中國國民黨
高雄市三民區寶國里,398,1028,630,5313,7362,0.7,黃兆華,民主進步黨
高雄市三民區寶安里,150,831,681,4810,6748,0.7,黃柏澤,中國國民黨
高雄市三民區寶德里,-63,582,645,3444,4795,0.7,潘進派,民主進步黨
高雄市三民區寶慶里,-39,307,346,1864,2617,0.7,陳昱昌,無
高雄市三民區寶業里,146,832,686,4259,5718,0.7,林煥然,民主進步黨
高雄市三民區寶民里,-230,402,632,2156,3027,0.7,陳詩椿,無
高雄市三民區寶泰里,-262,359,621,1838,2635,0.7,黃仲霖,民主進步黨
高雄市三民區寶獅里,-94,449,543,2490,3399,0.7,林昆明,無
高雄市三民區寶玉里,591,1121,530,5663,7765,0.7,黃昱椉,無
高雄市三民區寶珠里,-215,592,807,3573,6616,0.5,陳榮增,民主進步黨
高雄市三民區寶盛里,-110,603,713,3476,4684,0.7,任天霸,無
高雄市三民區寶興里,379,804,425,4676,6398,0.7,許慶銘,無
高雄市三民區寶華里,-230,403,633,2213,3016,0.7,李清樺,無
高雄市三民區寶龍里,-136,442,578,2919,3944,0.7,黃美琴,無
高雄市三民區川東里,-505,106,611,813,1167,0.7,李明海,無
高雄市三民區建東里,-302,123,425,733,1146,0.6,陳建藏,無
高雄市三民區德仁里,-240,200,440,1283,1772,0.7,袁碧嬌,民主進步黨
高雄市三民區德北里,-236,265,501,1568,2154,0.7,李仁祥,無
高雄市三民區德智里,-65,203,268,1526,1994,0.8,李明同,民主進步黨
高雄市三民區德東里,-344,83,427,564,735,0.8,許玉秀,無
高雄市三民區德行里,-371,93,464,785,1031,0.8,郭麗香,無
高雄市三民區德西里,-366,365,731,1414,1968,0.7,林財旺,無
高雄市三民區本上里,124,620,496,3301,4443,0.7,詹鶴,無
高雄市三民區本元里,306,644,338,3699,4945,0.7,吳朝桂,民主進步黨
高雄市三民區本和里,319,926,607,5054,6931,0.7,陳文旗,無
高雄市三民區本安里,50,588,538,3141,4221,0.7,王金堂,民主進步黨
高雄市三民區本揚里,242,939,697,5287,7062,0.7,蘇永樹,無
高雄市三民區本文里,-153,138,291,759,1050,0.7,郭和成,民主進步黨
高雄市三民區本武里,4,197,193,1217,1651,0.7,吳阿吉,民主進步黨
高雄市三民區本館里,417,1043,626,5954,8231,0.7,簡明鎮,無
高雄市三民區正興里,1324,1670,346,8247,11718,0.7,沈秀玲,民主進步黨
高雄市三民區正順里,10,476,466,2693,3689,0.7,黃冠惠,無
高雄市三民區民享里,-91,175,266,1383,1836,0.8,吳慶東,無
高雄市三民區港新里,-132,157,289,1078,1404,0.8,蘇麗玉,無
高雄市三民區港東里,-554,116,670,904,1319,0.7,張士賢,無
高雄市三民區港西里,-277,65,342,509,729,0.7,閩興傳,民主進步黨
高雄市三民區灣中里,111,608,497,3520,5191,0.7,楊宏明,無
高雄市三民區灣利里,-324,271,595,2154,2962,0.7,郭峻毅,民主進步黨
高雄市三民區灣勝里,-255,161,416,1306,1807,0.7,陳金櫃,民主進步黨
高雄市三民區灣子里,110,456,346,2715,3850,0.7,方相茗,無
高雄市三民區灣復里,-30,425,455,2434,3429,0.7,吳國清,無
高雄市三民區灣愛里,-67,302,369,1888,2855,0.7,邱清勳,無
高雄市三民區灣成里,-419,393,812,1930,2780,0.7,黃文良,無
高雄市三民區灣興里,-144,205,349,1349,1808,0.7,張文青,無
高雄市三民區灣華里,-329,330,659,1792,2528,0.7,高素女,中國國民黨
高雄市三民區立德里,-298,121,419,814,1126,0.7,林平長,中國國民黨
高雄市三民區立業里,-335,91,426,619,864,0.7,陳姵羽,無
高雄市三民區立誠里,-236,60,296,494,654,0.8,陳永進,中國國民黨
高雄市三民區精華里,-769,141,910,1069,1440,0.7,何佳憲,民主進步黨
高雄市三民區興德里,-71,238,309,1375,1883,0.7,陳國欽,無
高雄市三民區裕民里,-259,164,423,882,1227,0.7,陳水榮,無
高雄市三民區豐裕里,-169,228,397,1577,2250,0.7,謝錫元,無
高雄市三民區達仁里,-708,167,875,1000,1340,0.7,邱添富,民主進步黨
高雄市三民區達勇里,-451,95,546,626,878,0.7,李少緯,無
高雄市三民區達德里,-462,135,597,923,1209,0.8,陳國枝,無
高雄市三民區達明里,-629,143,772,1070,1472,0.7,張簡王玉珠,民主進步黨
高雄市三民區長明里,-532,107,639,699,982,0.7,林練丁,無
高雄市三民區鳳北里,-501,129,630,929,1234,0.8,鄭健村,無
高雄市三民區鳳南里,-315,114,429,707,964,0.7,王進祿,無
高雄市三民區鼎中里,-69,484,553,2783,3765,0.7,李水發,無
高雄市三民區鼎力里,-33,519,552,2846,3944,0.7,沈巽榮,無
高雄市三民區鼎強里,-85,307,392,1891,2669,0.7,林國石,無
高雄市三民區鼎泰里,2072,2799,727,15013,20625,0.7,張吉雄,無
高雄市三民區鼎盛里,594,991,397,5209,7339,0.7,謝有清,民主進步黨
高雄市三民區鼎西里,374,935,561,4946,6980,0.7,姚素眞,民主進步黨
高雄市三民區鼎金里,-103,454,557,2694,3913,0.7,高豐麟,無
高雄市仁武區中華里,-859,182,1041,1079,1563,0.7,林志榮,民主進步黨
高雄市仁武區五和里,514,772,258,3772,5351,0.7,林雅婷,民主進步黨
高雄市仁武區仁和里,-250,438,688,2349,3200,0.7,鄭諭澤,無
高雄市仁武區仁慈里,-184,400,584,2219,2880,0.8,洪月琴,民主進步黨
高雄市仁武區仁武里,53,677,624,3625,5377,0.7,劉俊彥,無
高雄市仁武區仁福里,-391,64,455,557,825,0.7,朱興,無
高雄市仁武區八卦里,2391,2929,538,13803,19278,0.7,謝秋江,無
高雄市仁武區大灣里,-136,665,801,3482,4828,0.7,謝瑋原,民主進步黨
高雄市仁武區後安里,-503,266,769,1784,2473,0.7,黃榮輝,無
高雄市仁武區文武里,587,1236,649,6633,9199,0.7,蔡進德,無
高雄市仁武區灣內里,554,1154,600,5917,8230,0.7,鄭文輝,民主進步黨
高雄市仁武區烏林里,-374,412,786,2321,3556,0.7,林文斌,民主進步黨
高雄市仁武區竹後里,-530,217,747,1589,2196,0.7,黃常志,無
高雄市仁武區考潭里,-502,282,784,1866,2548,0.7,蔡德明,無
高雄市仁武區赤山里,228,1030,802,5145,6978,0.7,謝青原,民主進步黨
高雄市仁武區高楠里,-133,486,619,2217,3004,0.7,李志能,無
高雄市內門區三平里,-266,56,322,389,604,0.6,洪生業,無
高雄市內門區中埔里,-226,39,265,363,514,0.7,謝清雄,無
高雄市內門區光興里,-471,71,542,431,616,0.7,王士訓,無
高雄市內門區內南里,-137,34,171,249,381,0.7,沈芳昌,無
高雄市內門區內東里,-302,46,348,508,713,0.7,陳明章,無
高雄市內門區內興里,-215,29,244,352,572,0.6,力永信,無
高雄市內門區內豊里,-526,85,611,765,1112,0.7,龔飛盛,無
高雄市內門區內門里,-461,79,540,625,896,0.7,蔡瓊鳳,無
高雄市內門區木柵里,-270,40,310,370,556,0.7,机素勤,無
高雄市內門區東埔里,-242,43,285,302,458,0.7,張錦泉,無
高雄市內門區永吉里,-300,23,323,248,404,0.6,李永坤,無
高雄市內門區永富里,-410,70,480,602,926,0.7,蒙勝南,無
高雄市內門區永興里,-121,28,149,240,370,0.6,陳順良,無
高雄市內門區溝坪里,-292,66,358,531,877,0.6,謝振明,無
高雄市內門區瑞山里,-139,21,160,206,302,0.7,黄淑玲,無
高雄市內門區石坑里,-351,43,394,312,477,0.7,劉文斌,無
高雄市內門區觀亭里,-247,158,405,1102,1588,0.7,許志芳,無
高雄市內門區金竹里,-268,36,304,401,603,0.7,林熾杉,無
高雄市六龜區中興里,-436,118,554,843,1354,0.6,陳信景,無
高雄市六龜區六龜里,-446,54,500,468,894,0.5,邱國輝,無
高雄市六龜區大津里,-84,30,114,210,291,0.7,林文察,無
高雄市六龜區寶來里,-453,50,503,478,823,0.6,沈振揚,無
高雄市六龜區文武里,-766,92,858,746,1321,0.6,鍾達煌,無
高雄市六龜區新威里,-211,52,263,430,675,0.6,邱民棟,無
高雄市六龜區新寮里,-289,38,327,401,596,0.7,朱玉雲,無
高雄市六龜區新發里,-340,52,392,470,880,0.5,劉俊麟,無
高雄市六龜區新興里,-374,51,425,381,626,0.6,邱瑞明,無
高雄市六龜區義寶里,-391,69,460,593,954,0.6,鍾啟鴻,無
高雄市六龜區興龍里,-310,34,344,407,742,0.5,張榮華,無
高雄市六龜區荖濃里,-480,90,570,708,1305,0.5,陳俊福,無
高雄市前金區三川里,-106,136,242,688,901,0.8,莊晉勲,無
高雄市前金區北金里,-340,86,426,590,823,0.7,林福枝,無
高雄市前金區博孝里,-430,104,534,727,1004,0.7,方文杰,民主進步黨
高雄市前金區國民里,-192,94,286,648,935,0.7,謝明致,無
高雄市前金區後金里,-226,80,306,472,638,0.7,施孟均,無
高雄市前金區復元里,-374,93,467,749,1034,0.7,黃千豪,無
高雄市前金區文東里,-265,135,400,849,1130,0.8,黃崑光,無
高雄市前金區文西里,-321,113,434,706,972,0.7,賴勇村,無
高雄市前金區新生里,-92,451,543,2574,3548,0.7,康文展,無
高雄市前金區東金里,-389,82,471,672,961,0.7,謝仲箎,無
高雄市前金區林投里,-194,91,285,659,1092,0.6,李明峰,無
高雄市前金區榮復里,-396,103,499,777,1031,0.8,顏炳豪,無
高雄市前金區民生里,-363,6,369,33,45,0.7,黃博群,無
高雄市前金區社東里,-293,139,432,997,1423,0.7,黃玉英,無
高雄市前金區社西里,-359,154,513,850,1149,0.7,薛寶琴,無
高雄市前金區草江里,-357,178,535,966,1361,0.7,陳振琦,無
高雄市前金區長城里,-615,118,733,925,1334,0.7,李林春蘭,無
高雄市前金區長生里,-276,167,443,1190,1657,0.7,陳宗佐,無
高雄市前金區長興里,-427,154,581,859,1221,0.7,白宗正,無
高雄市前金區青山里,-246,214,460,1349,1922,0.7,江武吉,無
高雄市前鎮區仁愛里,-649,133,782,955,1294,0.7,楊朝雄,民主進步黨
高雄市前鎮區信德里,-331,224,555,1488,2138,0.7,李竣帆,無
高雄市前鎮區信義里,-486,130,616,949,1339,0.7,魏伯曆,民主進步黨
高雄市前鎮區前鎮里,-747,127,874,936,1271,0.7,許澤能,無
高雄市前鎮區平昌里,-225,62,287,457,687,0.7,高琅璋,民主進步黨
高雄市前鎮區平等里,-219,190,409,1427,2942,0.5,施長欽,民主進步黨
高雄市前鎮區建隆里,-582,142,724,970,1369,0.7,林得祿,中國國民黨
高雄市前鎮區復國里,-334,272,606,1811,2483,0.7,呂建霖,民主進步黨
高雄市前鎮區德昌里,-97,184,281,1224,1768,0.7,李正義,無
高雄市前鎮區忠孝里,-263,423,686,2382,3279,0.7,陳宜汝,無
高雄市前鎮區忠純里,175,580,405,3782,5147,0.7,艾台民,中國國民黨
高雄市前鎮區忠誠里,-271,202,473,1365,1874,0.7,吳安美,中國國民黨
高雄市前鎮區振興里,-358,304,662,1716,2375,0.7,鍾明憲,無
高雄市前鎮區明孝里,-212,176,388,1230,1684,0.7,林浤澤,無
高雄市前鎮區明正里,2,590,588,3515,4852,0.7,王春茂,民主進步黨
高雄市前鎮區明禮里,-599,162,761,1088,1544,0.7,莊志明,民主進步黨
高雄市前鎮區明義里,-440,236,676,1642,2201,0.7,翁碩聰,無
高雄市前鎮區明道里,-566,90,656,780,1082,0.7,王進亨,民主進步黨
高雄市前鎮區民權里,-95,471,566,2864,3774,0.8,吳政昇,無
高雄市前鎮區瑞北里,-205,367,572,2209,3124,0.7,陳眞玟,民主進步黨
高雄市前鎮區瑞南里,-121,549,670,3158,4359,0.7,張木春,民主進步黨
高雄市前鎮區瑞和里,-164,184,348,1288,1768,0.7,陳文人,民主進步黨
高雄市前鎮區瑞崗里,-442,273,715,1766,2405,0.7,洪金山,民主進步黨
高雄市前鎮區瑞平里,42,415,373,2472,3262,0.8,陳柏村,無
高雄市前鎮區瑞文里,-415,274,689,1634,2305,0.7,邱吉弘,無
高雄市前鎮區瑞昌里,-147,387,534,2167,2996,0.7,陳裕達,無
高雄市前鎮區瑞東里,-220,254,474,1534,2186,0.7,許振稽,民主進步黨
高雄市前鎮區瑞祥里,-47,566,613,3059,4239,0.7,陳紫鳳,無
高雄市前鎮區瑞竹里,-59,390,449,1503,2031,0.7,許益彰,無
高雄市前鎮區瑞興里,-540,245,785,1751,2423,0.7,陳俊源,民主進步黨
高雄市前鎮區瑞華里,-175,510,685,3084,4201,0.7,蘇榮隆,無
高雄市前鎮區瑞西里,-587,251,838,1754,2462,0.7,蘇悦敏,民主進步黨
高雄市前鎮區瑞誠里,-114,329,443,1797,2475,0.7,林雪娥,無
高雄市前鎮區瑞豐里,-89,334,423,1845,2530,0.7,邱達雲,無
高雄市前鎮區瑞隆里,-334,385,719,2329,3264,0.7,楊家鴻,無
高雄市前鎮區盛興里,-395,277,672,1788,2634,0.7,鍾鳳美,無
高雄市前鎮區盛豐里,-320,318,638,2066,2951,0.7,王志濱,無
高雄市前鎮區竹中里,33,392,359,2409,3275,0.7,莊茂榮,無
高雄市前鎮區竹內里,-598,169,767,1064,1487,0.7,蘇慶忠,無
高雄市前鎮區竹北里,60,349,289,1806,2469,0.7,孫偉光,無
高雄市前鎮區竹南里,334,969,635,4731,6503,0.7,張銓聖,無
高雄市前鎮區竹東里,-218,229,447,1404,2013,0.7,李春桂,無
高雄市前鎮區竹西里,-142,491,633,2873,3871,0.7,林金良,無
高雄市前鎮區興中里,10,314,304,1954,2877,0.7,狄金山,中國國民黨
高雄市前鎮區興仁里,-283,71,354,511,690,0.7,張秋敏,無
高雄市前鎮區興化里,-284,72,356,487,680,0.7,朱蘇來蔭,無
高雄市前鎮區興東里,116,716,600,3908,5441,0.7,陳建銘,無
高雄市前鎮區興邦里,-285,215,500,1208,1654,0.7,薛文龍,無
高雄市前鎮區良和里,-269,328,597,2008,2719,0.7,陳瑞銓,中國國民黨
高雄市前鎮區草衙里,440,984,544,6106,8923,0.7,李忠正,無
高雄市前鎮區西山里,-30,339,369,2269,3144,0.7,陳天香,無
高雄市前鎮區西甲里,-59,210,269,1465,2039,0.7,潘石誠,民主進步黨
高雄市前鎮區鎮中里,-461,99,560,596,843,0.7,湯淑貞,無
高雄市前鎮區鎮北里,-487,118,605,816,1128,0.7,許昭福,無
高雄市前鎮區鎮昌里,-201,218,419,1402,1903,0.7,涂明鏡,無
高雄市前鎮區鎮東里,-272,182,454,1256,1623,0.8,蔡川士,無
高雄市前鎮區鎮榮里,-315,203,518,1357,1960,0.7,黃士誠,民主進步黨
高雄市前鎮區鎮海里,-27,480,507,2750,3848,0.7,蔡葉珍妮,民主進步黨
高雄市前鎮區鎮陽里,-444,102,546,685,962,0.7,鄭蔡秀燕,無
高雄市大寮區三隆里,-129,534,663,3262,4558,0.7,蕭國欽,民主進步黨
高雄市大寮區上寮里,-374,402,776,2170,3043,0.7,洪巧璇,無
高雄市大寮區中庄里,1029,1407,378,7481,10626,0.7,林烔彬,無
高雄市大寮區中興里,227,593,366,3869,5690,0.7,曾幸福,中國國民黨
高雄市大寮區內坑里,349,639,290,3679,5793,0.6,黃裕玲,無
高雄市大寮區前庄里,-402,255,657,1623,2229,0.7,陳金晚,中國國民黨
高雄市大寮區大寮里,205,742,537,4047,6033,0.7,蕭清翔,無
高雄市大寮區山頂里,139,936,797,5051,7246,0.7,簡子銘,中國國民黨
高雄市大寮區後庄里,224,980,756,5425,7588,0.7,鄭德文,無
高雄市大寮區忠義里,-85,119,204,769,1138,0.7,邴健鵬,中國國民黨
高雄市大寮區拷潭里,-174,135,309,925,1318,0.7,董鳳松,民主進步黨
高雄市大寮區新厝里,-249,175,424,1111,1614,0.7,張簡龍星,無
高雄市大寮區昭明里,45,436,391,2541,3722,0.7,張簡助昇,無
高雄市大寮區會社里,195,647,452,3881,6057,0.6,吳銀國,無
高雄市大寮區會結里,-150,115,265,773,1146,0.7,蔡金獅,中國國民黨
高雄市大寮區永芳里,127,811,684,4662,6674,0.7,簡基成,無
高雄市大寮區江山里,-220,166,386,983,1340,0.7,許世川,無
高雄市大寮區溪寮里,-125,223,348,1472,1975,0.7,王基安,無
高雄市大寮區潮寮里,-97,358,455,2323,3298,0.7,徐新生,無
高雄市大寮區琉球里,60,713,653,3629,5017,0.7,郭秀品,無
高雄市大寮區義仁里,-271,157,428,1195,1746,0.7,許明得,無
高雄市大寮區義和里,-486,248,734,1591,2156,0.7,劉志陽,無
高雄市大寮區翁園里,165,506,341,2900,3906,0.7,蔡順豐,無
高雄市大寮區過溪里,-111,316,427,1713,2439,0.7,陳秀英,無
高雄市大樹區三和里,-423,163,586,1115,1650,0.7,黃重信,無
高雄市大樹區久堂里,-154,484,638,2838,3988,0.7,張勝鋒,中國國民黨
高雄市大樹區九曲里,77,623,546,3463,5106,0.7,潘德勝,中國國民黨
高雄市大樹區井腳里,-71,141,212,1051,1433,0.7,黃沼人,無
高雄市大樹區和山里,-382,90,472,663,957,0.7,吳順治,無
高雄市大樹區大坑里,-465,66,531,460,681,0.7,吳進雄,無
高雄市大樹區大樹里,-91,339,430,2027,2855,0.7,梁源泰,無
高雄市大樹區姑山里,-293,93,386,691,952,0.7,王莊素真,無
高雄市大樹區小坪里,-408,130,538,892,1252,0.7,郭秀密,無
高雄市大樹區檨腳里,-388,258,646,1748,2495,0.7,吳文雄,無
高雄市大樹區水安里,-131,261,392,1656,2307,0.7,林正道,無
高雄市大樹區水寮里,-374,217,591,1566,2115,0.7,史榮瑞,無
高雄市大樹區溪埔里,-107,140,247,999,1414,0.7,張耀珍,無
高雄市大樹區竹寮里,-347,331,678,1845,2591,0.7,鄭榕華,無
高雄市大樹區統嶺里,-262,42,304,438,626,0.7,許瑞楠,無
高雄市大樹區興山里,-353,138,491,963,1383,0.7,尹平成,無
高雄市大樹區興田里,-240,133,373,1298,1828,0.7,曾金益,中國國民黨
高雄市大樹區龍目里,-230,154,384,1157,1677,0.7,陳榮清,無
高雄市大社區三奶里,-145,297,442,1869,2597,0.7,許丁春,無
高雄市大社區中里里,-45,375,420,2220,3143,0.7,李旭仁,無
高雄市大社區保安里,-41,434,475,2215,3075,0.7,林義萬,民主進步黨
高雄市大社區保社里,-128,447,575,2313,3242,0.7,許清泉,民主進步黨
高雄市大社區嘉誠里,-331,89,420,576,855,0.7,侯景耀,無
高雄市大社區大社里,286,590,304,3351,4821,0.7,林英陸,民主進步黨
高雄市大社區神農里,290,634,344,3402,4814,0.7,葉秀英,無
高雄市大社區翠屏里,-359,173,532,1162,1587,0.7,匡淑芳,無
高雄市大社區觀音里,141,668,527,3784,5257,0.7,陳竑憲,無
高雄市小港區三苓里,-507,320,827,1927,2722,0.7,郭冠霖,無
高雄市小港區中厝里,38,440,402,2435,3579,0.7,方蒼賢,無
高雄市小港區二苓里,-238,388,626,2449,3565,0.7,馮見仁,無
高雄市小港區六苓里,-270,191,461,1053,1401,0.8,陳美秀,無
高雄市小港區合作里,-230,325,555,1970,2704,0.7,蘇麗美,民主進步黨
高雄市小港區坪頂里,117,763,646,4116,6113,0.7,梁憲宗,無
高雄市小港區大坪里,-258,378,636,2039,2951,0.7,梁正義,無
高雄市小港區大苓里,-455,294,749,1756,2460,0.7,歐世緯,無
高雄市小港區孔宅里,-35,494,529,2642,3742,0.7,吳蘆恩,無
高雄市小港區宏亮里,-512,388,900,2171,3120,0.7,宋震寶,無
高雄市小港區小港里,-255,148,403,881,1274,0.7,洪世春,無
高雄市小港區山明里,853,1509,656,7986,11435,0.7,陳阿子,無
高雄市小港區山東里,-154,360,514,2123,3074,0.7,楊坤止,無
高雄市小港區店鎮里,86,616,530,3817,5536,0.7,楊文良,無
高雄市小港區廈莊里,346,622,276,2965,4255,0.7,李茂群,無
高雄市小港區松山里,-201,395,596,2364,3196,0.7,王美華,無
高雄市小港區松金里,-285,262,547,1400,2009,0.7,沈添福,無
高雄市小港區桂林里,557,1034,477,5367,7558,0.7,侯原庭,無
高雄市小港區正苓里,-56,463,519,2650,3859,0.7,吳惠加,無
高雄市小港區泰山里,-153,393,546,2420,3370,0.7,吳莧山,無
高雄市小港區港南里,-35,398,433,2012,3219,0.6,王秋宏,無
高雄市小港區港口里,-85,356,441,2209,3062,0.7,劉峰吉,無
高雄市小港區港后里,-298,310,608,1861,2527,0.7,柯文世,民主進步黨
高雄市小港區港墘里,-471,216,687,1191,1675,0.7,吳文德,無
高雄市小港區港明里,-298,355,653,2026,2990,0.7,李文正,無
高雄市小港區港正里,-334,312,646,1771,2464,0.7,方林秀娥,無
高雄市小港區港興里,-185,293,478,1684,2309,0.7,歐慧玲,民主進步黨
高雄市小港區濟南里,-238,478,716,2964,4162,0.7,薛審,無
高雄市小港區青島里,-465,139,604,999,1378,0.7,戴又媛,中國國民黨
高雄市小港區順苓里,-119,568,687,2956,4328,0.7,呂在和,無
高雄市小港區高松里,-232,550,782,3015,4391,0.7,梁志安,無
高雄市小港區鳳宮里,-174,358,532,1800,2655,0.7,曾清全,無
高雄市小港區鳳林里,-704,302,1006,2166,3124,0.7,許再生,民主進步黨
高雄市小港區鳳森里,-432,245,677,1604,2323,0.7,陳信雄,無
高雄市小港區鳳源里,-223,302,525,1729,2633,0.7,張宇讚,無
高雄市小港區鳳興里,-293,311,604,1771,2600,0.7,洪富賢,無
高雄市小港區鳳鳴里,-576,349,925,2133,3185,0.7,李月雲,無
高雄市小港區龍鳳里,-279,333,612,2120,3156,0.7,黃文裕,無
高雄市岡山區三和里,-307,88,395,614,838,0.7,陳泰龍,無
高雄市岡山區仁壽里,-66,365,431,2333,3182,0.7,劉永裕,無
高雄市岡山區仁義里,-337,178,515,1375,1772,0.8,顏茂吉,無
高雄市岡山區信義里,-189,251,440,1122,1584,0.7,石秀霞,無
高雄市岡山區前峰里,-370,369,739,1940,2733,0.7,蔡佩玲,無
高雄市岡山區劉厝里,-366,163,529,1040,1362,0.8,劉慶煌,民主進步黨
高雄市岡山區協和里,-188,464,652,2511,3421,0.7,呂煌龍,無
高雄市岡山區協榮里,-405,256,661,1470,2022,0.7,蔡麗琴,無
高雄市岡山區台上里,293,816,523,4152,5779,0.7,李金本,無
高雄市岡山區和平里,-76,77,153,336,424,0.8,葉春蘭,無
高雄市岡山區嘉峰里,11,201,190,1231,1694,0.7,高昭南,無
高雄市岡山區嘉興里,-81,368,449,2363,3202,0.7,柯俊良,無
高雄市岡山區壽天里,-173,407,580,2293,3089,0.7,莊証州,無
高雄市岡山區壽峰里,-346,296,642,1548,2145,0.7,李美麗,無
高雄市岡山區大莊里,-600,99,699,691,953,0.7,佘能文,無
高雄市岡山區大遼里,-447,166,613,1017,1353,0.8,蔡錫琛,無
高雄市岡山區岡山里,176,535,359,2805,4259,0.7,劉天賦,無
高雄市岡山區平安里,-435,162,597,1097,1488,0.7,劉登榮,無
高雄市岡山區後協里,-85,635,720,3379,4689,0.7,李再富,無
高雄市岡山區後紅里,-172,579,751,2943,4080,0.7,韓嘉嘉,無
高雄市岡山區忠孝里,117,300,183,1965,2728,0.7,江國華,中國國民黨
高雄市岡山區本洲里,-49,206,255,1148,1609,0.7,施清德,無
高雄市岡山區潭底里,-372,71,443,562,760,0.7,陳勝傑,無
高雄市岡山區灣裡里,-191,226,417,1319,1798,0.7,林仁傑,無
高雄市岡山區為隨里,-112,181,293,975,1283,0.8,蔡正旭,無
高雄市岡山區白米里,-189,281,470,1489,2004,0.7,曾詠妮,無
高雄市岡山區石潭里,-345,208,553,1392,1789,0.8,廖壹正,無
高雄市岡山區碧紅里,5,503,498,2677,3735,0.7,李有財,無
高雄市岡山區福興里,-373,139,512,801,1029,0.8,何進柱,無
高雄市岡山區程香里,269,529,260,2902,3939,0.7,李州正,無
高雄市岡山區竹圍里,218,1015,797,4846,6685,0.7,何榮裕,無
高雄市岡山區維仁里,-256,47,303,338,463,0.7,戴清福,無
高雄市岡山區華崗里,-273,175,448,1166,1492,0.8,杜光達,無
高雄市左營區中北里,-312,43,355,422,569,0.7,謝瑞真,無
高雄市左營區中南里,-214,35,249,335,486,0.7,蔣金守,無
高雄市左營區光輝里,-69,278,347,1719,2402,0.7,傅琪隆,中國國民黨
高雄市左營區合群里,-238,251,489,1812,2459,0.7,倪同慧,中國國民黨
高雄市左營區城南里,-197,40,237,325,469,0.7,謝金得,無
高雄市左營區埤北里,-455,105,560,811,1183,0.7,李復慶,無
高雄市左營區埤東里,-314,71,385,633,874,0.7,鄒秀華,中國國民黨
高雄市左營區埤西里,-321,72,393,589,829,0.7,余清榮,無
高雄市左營區尾北里,-263,371,634,2215,3079,0.7,柯錦德,中國國民黨
高雄市左營區尾南里,-302,66,368,481,681,0.7,余建明,無
高雄市左營區尾西里,-382,98,480,712,944,0.8,郭錦彬,無
高雄市左營區屏山里,-363,118,481,1011,1500,0.7,吳榮秀,中國國民黨
高雄市左營區崇實里,-113,491,604,2334,3175,0.7,吳武雄,無
高雄市左營區廍北里,-107,44,151,309,407,0.8,薛朝文,無
高雄市左營區廍南里,-231,45,276,404,562,0.7,陳美惠,無
高雄市左營區廟北里,-243,66,309,583,811,0.7,蘇進雄,無
高雄市左營區廟東里,-363,53,416,580,791,0.7,謝惠娟,無
高雄市左營區新上里,2840,3310,470,18268,25075,0.7,王櫻樺,中國國民黨
高雄市左營區新下里,1273,1921,648,10141,13984,0.7,黃慶德,中國國民黨
高雄市左營區新中里,-307,428,735,2584,3557,0.7,黃昱誌,無
高雄市左營區新光里,1102,1809,707,9843,13612,0.7,黃麗純,中國國民黨
高雄市左營區明建里,-143,156,299,626,841,0.7,顏靜玉,無
高雄市左營區果峰里,-560,125,685,1001,1444,0.7,曾瑞水,中國國民黨
高雄市左營區果惠里,-501,129,630,986,1374,0.7,鄭夙雅,無
高雄市左營區果貿里,-361,265,626,1835,2588,0.7,韓得平,中國國民黨
高雄市左營區永清里,-57,171,228,550,857,0.6,郭鎮國,中國國民黨
高雄市左營區海勝里,-71,519,590,3865,5326,0.7,梁西榮,中國國民黨
高雄市左營區祥和里,-155,12,167,63,92,0.7,劉德文,中國國民黨
高雄市左營區福山里,4934,5276,342,24228,34263,0.7,葉德龍,中國國民黨
高雄市左營區聖南里,-261,53,314,365,507,0.7,陳勇利,無
高雄市左營區聖后里,-273,73,346,541,708,0.8,裴天成,無
高雄市左營區聖西里,-144,3,147,17,26,0.7,黃山本,無
高雄市左營區自助里,-69,414,483,1362,1952,0.7,劉淯騰,民主進步黨
高雄市左營區莒光里,-673,149,822,1132,1712,0.7,柯麗枝,無
高雄市左營區菜公里,3612,4098,486,20751,28791,0.7,王振華,中國國民黨
高雄市左營區路東里,-293,60,353,506,672,0.8,黃秀綢,無
高雄市左營區進學里,-423,132,555,1081,2563,0.4,曹順雄,無
高雄市左營區頂北里,-313,48,361,394,524,0.8,詹正國,無
高雄市左營區頂西里,-425,78,503,649,866,0.7,方秀娟,民主進步黨
高雄市彌陀區光和里,-624,125,749,882,1206,0.7,林清火,無
高雄市彌陀區南寮里,-101,226,327,1441,2032,0.7,吳宏桂,無
高雄市彌陀區彌仁里,-205,35,240,350,503,0.7,梁天賞,無
高雄市彌陀區彌壽里,-367,79,446,576,749,0.8,吳義雄,無
高雄市彌陀區彌陀里,-407,212,619,1236,1666,0.7,林煌陸,無
高雄市彌陀區彌靖里,-429,178,607,1281,1774,0.7,吳志強,無
高雄市彌陀區文安里,-254,157,411,1119,1615,0.7,李泰山,無
高雄市彌陀區海尾里,-592,79,671,558,799,0.7,蘇政峯,無
高雄市彌陀區漯底里,-549,124,673,812,1093,0.7,孫萬賜,無
高雄市彌陀區舊港里,-421,174,595,1114,1501,0.7,李明山,無
高雄市彌陀區過港里,-428,105,533,619,883,0.7,張金長,無
高雄市彌陀區鹽埕里,-440,240,680,1451,1950,0.7,李允條,無
高雄市新興區中東里,-334,254,588,1679,2658,0.6,林明雄,無
高雄市新興區仁聲里,-310,117,427,674,1004,0.7,蕭育霞,無
高雄市新興區光耀里,-59,259,318,1536,2122,0.7,吳秀鈴,民主進步黨
高雄市新興區南港里,-314,179,493,1405,1841,0.8,陳福明,民主進步黨
高雄市新興區大明里,-391,92,483,739,1008,0.7,徐慶宗,民主進步黨
高雄市新興區建興里,-275,106,381,608,899,0.7,薛富升,民主進步黨
高雄市新興區建華里,-299,94,393,594,833,0.7,吳文欽,無
高雄市新興區德政里,-278,74,352,458,613,0.7,謝國男,無
高雄市新興區德望里,-191,205,396,1276,1782,0.7,林郭麗玉,無
高雄市新興區德生里,-250,361,611,2006,2758,0.7,吳三雄,民主進步黨
高雄市新興區愛平里,-308,133,441,690,943,0.7,高文龍,無
高雄市新興區成功里,-619,167,786,971,1319,0.7,童健良,中國國民黨
高雄市新興區振成里,-206,99,305,697,995,0.7,陳敏夫,無
高雄市新興區振華里,-311,103,414,726,1006,0.7,吳劍生,中國國民黨
高雄市新興區文昌里,-117,361,478,2085,2838,0.7,劉育洋,中國國民黨
高雄市新興區新江里,-403,112,515,708,1040,0.7,王金龍,無
高雄市新興區明莊里,-266,66,332,458,671,0.7,莊其章,無
高雄市新興區東坡里,-587,106,693,838,1138,0.7,楊福順,民主進步黨
高雄市新興區榮治里,-259,78,337,498,678,0.7,許淑芬,無
高雄市新興區正氣里,-520,139,659,943,1286,0.7,沈玉玲,無
高雄市新興區永寧里,-288,170,458,979,1372,0.7,施澤民,民主進步黨
高雄市新興區浩然里,-246,194,440,1230,1718,0.7,張榮源,中國國民黨
高雄市新興區漢民里,-166,82,248,521,723,0.7,李賢宗,無
高雄市新興區玉衡里,-257,63,320,478,666,0.7,蔡瑞彬,無
高雄市新興區秋山里,-341,102,443,662,989,0.7,許吳瑞珍,無
高雄市新興區興昌里,-247,108,355,637,868,0.7,黃少嫻,無
高雄市新興區華聲里,-314,97,411,640,892,0.7,林禮志,無
高雄市新興區蕉園里,-388,84,472,526,702,0.7,鄭凱隆,無
高雄市新興區長驛里,-284,97,381,617,904,0.7,葉智陽,無
高雄市新興區開平里,-157,358,515,2412,3211,0.8,陳朝居,無
高雄市新興區順昌里,-211,270,481,1559,2111,0.7,林朱堂,無
高雄市新興區黎明里,-273,71,344,572,806,0.7,許耀科,民主進步黨
高雄市旗山區三協里,-247,269,516,1510,2158,0.7,劉文寶,無
高雄市旗山區上洲里,-400,113,513,756,1109,0.7,柯瑞斌,無
高雄市旗山區中寮里,-97,11,108,124,176,0.7,洪萬祥,無
高雄市旗山區中正里,-110,131,241,889,1380,0.6,郭舜明,無
高雄市旗山區中洲里,-360,13,373,105,154,0.7,羅昱晴,無
高雄市旗山區南勝里,-549,151,700,1363,1997,0.7,廖宗吉,無
高雄市旗山區南洲里,-367,118,485,939,1363,0.7,黃吉祥,無
高雄市旗山區圓富里,-56,184,240,1130,1735,0.7,歐忠更,無
高雄市旗山區大山里,-638,129,767,922,1341,0.7,柯旗旺,無
高雄市旗山區大德里,-203,265,468,1544,2205,0.7,曾慶義,無
高雄市旗山區大林里,-173,100,273,808,1271,0.6,莊柏松,無
高雄市旗山區太平里,-462,223,685,1513,2132,0.7,鄭明成,無
高雄市旗山區廣福里,-190,60,250,401,597,0.7,宋銘新,無
高雄市旗山區新光里,-341,63,404,526,731,0.7,陳峯翔,無
高雄市旗山區東平里,-247,186,433,1337,1857,0.7,石正忠,無
高雄市旗山區東昌里,-417,97,514,662,960,0.7,邱清郎,無
高雄市旗山區永和里,62,341,279,2083,3090,0.7,周銹玉,無
高雄市旗山區湄洲里,-98,165,263,986,1486,0.7,陳聖允,民主進步黨
高雄市旗山區瑞吉里,-195,196,391,1310,1879,0.7,游俊樺,無
高雄市旗山區竹峰里,-227,168,395,1024,1452,0.7,郭信東,無
高雄市旗山區鯤洲里,-262,65,327,625,852,0.7,柯文化,民主進步黨
高雄市旗津區上竹里,-530,278,808,1810,2702,0.7,陳仲智,無
高雄市旗津區中洲里,-257,157,414,1228,1812,0.7,郭美伶,無
高雄市旗津區中興里,-512,259,771,1736,2480,0.7,郭茂盛,無
高雄市旗津區中華里,-372,144,516,1064,1516,0.7,徐漢仁,無
高雄市旗津區北汕里,-111,273,384,1672,2596,0.6,林秀英,無
高雄市旗津區南汕里,-469,203,672,1325,2060,0.6,蔡明議,無
高雄市旗津區安順里,-191,93,284,604,920,0.7,莊武益,無
高雄市旗津區實踐里,-300,176,476,944,1481,0.6,楊台生,無
高雄市旗津區復興里,-539,130,669,931,1429,0.7,張順皇,無
高雄市旗津區慈愛里,-278,207,485,1401,2222,0.6,夏啓峯,無
高雄市旗津區振興里,-604,158,762,1068,1547,0.7,黃見益,無
高雄市旗津區旗下里,-291,124,415,824,1206,0.7,杜勝輝,無
高雄市旗津區永安里,-334,112,446,724,1083,0.7,黃修和,無
高雄市杉林區上平里,-61,98,159,879,1467,0.6,張福松,無
高雄市杉林區大愛里,-368,107,475,803,1428,0.6,陳木源,無
高雄市杉林區新庄里,-176,96,272,862,1403,0.6,陳勤招,無
高雄市杉林區月眉里,-156,156,312,1212,2037,0.6,官梅英,無
高雄市杉林區月美里,-759,83,842,751,1171,0.6,劉曉君,無
高雄市杉林區木梓里,-300,33,333,368,640,0.6,林同德,無
高雄市杉林區杉林里,-262,35,297,319,555,0.6,陳明昌,無
高雄市杉林區集來里,-323,70,393,676,1178,0.6,楊正雄,無
高雄市林園區中厝里,-148,301,449,1955,2888,0.7,劉誌華,中國國民黨
高雄市林園區中汕里,-404,183,587,1399,2119,0.7,黃國發,無
高雄市林園區中芸里,-188,162,350,1196,1686,0.7,謝樹來,無
高雄市林園區中門里,-483,270,753,1660,2445,0.7,蘇信成,無
高雄市林園區五福里,-265,306,571,1602,2524,0.6,洪月珍,無
高雄市林園區仁愛里,-354,313,667,2091,2874,0.7,呂繼承,無
高雄市林園區北汕里,-252,148,400,969,1505,0.6,謝宿惠,無
高雄市林園區廣應里,-293,383,676,2364,3357,0.7,陳玫玲,無
高雄市林園區文賢里,-275,305,580,1685,2345,0.7,黃三源,無
高雄市林園區東林里,-108,312,420,1916,2849,0.7,盧盈叡,無
高雄市林園區東汕里,-323,110,433,762,1175,0.6,王福成,中國國民黨
高雄市林園區林內里,-64,222,286,1307,1915,0.7,黃清景,無
高雄市林園區林園里,-111,327,438,2070,2923,0.7,黃盟松,無
高雄市林園區林家里,-341,191,532,1231,1780,0.7,林明田,無
高雄市林園區港嘴里,-897,159,1056,1139,1646,0.7,蔡明興,無
高雄市林園區港埔里,-179,210,389,1222,1722,0.7,吳石南,無
高雄市林園區溪州里,-186,522,708,2774,4110,0.7,黃國輝,無
高雄市林園區潭頭里,-384,290,674,1777,2616,0.7,劉建德,無
高雄市林園區王公里,-126,455,581,2734,3972,0.7,洪進財,無
高雄市林園區西汕里,-328,32,360,227,351,0.6,邱鐘城,無
高雄市林園區西溪里,-326,339,665,2256,3304,0.7,李文通,無
高雄市林園區頂厝里,-82,528,610,3080,4544,0.7,陳碧對,無
高雄市林園區鳳芸里,-319,157,476,1237,1695,0.7,王泰山,無
高雄市林園區龔厝里,-391,146,537,1007,1397,0.7,龔芳生,無
高雄市桃源區勤和里,-67,37,104,258,455,0.6,曾江清水,無
高雄市桃源區寶山里,-304,59,363,453,732,0.6,陳燕霜,無
高雄市桃源區建山里,-382,35,417,193,290,0.7,陳建億,無
高雄市桃源區復興里,-66,27,93,171,281,0.6,江孫財,無
高雄市桃源區拉芙蘭里,-165,31,196,267,474,0.6,謝貴奇,無
高雄市桃源區桃源里,-521,16,537,129,246,0.5,高慕源,無
高雄市桃源區梅山里,-116,18,134,182,263,0.7,顏忠義,無
高雄市桃源區高中里,-274,47,321,377,648,0.6,胡益明,無
高雄市梓官區中崙里,-379,121,500,817,1078,0.8,歐樹發,無
高雄市梓官區信蚵里,-573,273,846,1719,2462,0.7,曾盈豐,無
高雄市梓官區典寶里,-145,330,475,2104,2913,0.7,洪文清,無
高雄市梓官區同安里,-264,197,461,1136,1572,0.7,蔣榮三,無
高雄市梓官區大舍里,-289,347,636,2121,2972,0.7,歐淼宗,無
高雄市梓官區智蚵里,-139,362,501,2291,3246,0.7,鄭柏政,無
高雄市梓官區梓信里,-333,237,570,1514,2034,0.7,蘇上火,無
高雄市梓官區梓和里,-264,217,481,1629,2130,0.8,姜志豪,無
高雄市梓官區梓平里,-717,172,889,1084,1406,0.8,黃常吉,無
高雄市梓官區梓義里,-100,237,337,1453,2086,0.7,陳榮富,無
高雄市梓官區禮蚵里,-211,150,361,1051,1492,0.7,蔡添寳,無
高雄市梓官區茄苳里,-340,253,593,1525,2165,0.7,劉和村,無
高雄市梓官區赤崁里,-169,173,342,1251,1777,0.7,蔡良鑑,中國國民黨
高雄市梓官區赤東里,-71,224,295,1565,2152,0.7,郭錦成,無
高雄市梓官區赤西里,-357,71,428,532,760,0.7,劉英凱,無
高雄市楠梓區中和里,513,918,405,3585,5116,0.7,楊亷政,無
高雄市楠梓區中興里,-523,365,888,1680,2329,0.7,黃朝吉,無
高雄市楠梓區中陽里,-426,437,863,2354,3420,0.7,李添發,無
高雄市楠梓區久昌里,115,370,255,1939,2801,0.7,辜清桐,無
高雄市楠梓區五常里,428,886,458,4267,6378,0.7,曾榮璋,無
高雄市楠梓區享平里,-16,408,424,2201,3253,0.7,陳顯能,無
高雄市楠梓區仁昌里,211,757,546,3500,5030,0.7,王永坤,中國國民黨
高雄市楠梓區加昌里,654,1050,396,5592,7966,0.7,劉秀英,無
高雄市楠梓區和昌里,-389,193,582,1434,1986,0.7,周海玲,無
高雄市楠梓區國昌里,-35,289,324,1636,2308,0.7,王晟境,無
高雄市楠梓區大昌里,-150,239,389,1434,2059,0.7,戴嘉育,中國國民黨
高雄市楠梓區宏南里,-204,86,290,577,788,0.7,張夢麒,無
高雄市楠梓區宏昌里,-216,398,614,2278,3183,0.7,劉秀桃,無
高雄市楠梓區宏榮里,-230,333,563,1832,2500,0.7,陳宏榮,中國國民黨
高雄市楠梓區宏毅里,-335,252,587,1560,2088,0.7,馮靖絨,無
高雄市楠梓區廣昌里,-556,292,848,2079,2882,0.7,蔡文東,無
高雄市楠梓區建昌里,-235,287,522,1763,2510,0.7,曾讚義,中國國民黨
高雄市楠梓區惠楠里,-174,285,459,1479,2218,0.7,張珮榕,無
高雄市楠梓區惠民里,115,660,545,3233,4594,0.7,張淑分,無
高雄市楠梓區惠豐里,240,656,416,3331,4727,0.7,黃意玲,無
高雄市楠梓區慶昌里,-212,326,538,2263,3064,0.7,陳玉梅,中國國民黨
高雄市楠梓區東寧里,59,800,741,3384,4734,0.7,蘇吳錦秀,無
高雄市楠梓區泰昌里,-618,143,761,995,1424,0.7,鄭嘉平,無
高雄市楠梓區清豐里,2774,3183,409,15667,21789,0.7,戴佑東,無
高雄市楠梓區玉屏里,-151,228,379,1584,2079,0.8,洪千雅,無
高雄市楠梓區瑞屏里,-184,401,585,2406,3411,0.7,郭進和,無
高雄市楠梓區盛昌里,82,693,611,3944,5386,0.7,杜炎明,無
高雄市楠梓區福昌里,-392,231,623,1583,2088,0.8,張育綺,無
高雄市楠梓區秀昌里,-44,230,274,1510,2055,0.7,張明全,中國國民黨
高雄市楠梓區稔田里,-442,176,618,1215,1616,0.8,陳瑞輅,無
高雄市楠梓區翠屏里,1823,2239,416,10740,15653,0.7,吳永晨,無
高雄市楠梓區興昌里,244,552,308,3096,4291,0.7,謝騏襄,無
高雄市楠梓區藍田里,1253,1605,352,6127,8296,0.7,謝坤易,民主進步黨
高雄市楠梓區裕昌里,172,658,486,3348,4687,0.7,郭明勲,無
高雄市楠梓區金田里,176,606,430,3021,4179,0.7,邱世宗,無
高雄市楠梓區錦屏里,-366,200,566,1492,1979,0.8,蔡甲庚,無
高雄市楠梓區隆昌里,-92,300,392,1679,2337,0.7,蔡淑貞,中國國民黨
高雄市橋頭區三德里,-509,70,579,585,756,0.8,劉崇凱,無
高雄市橋頭區中崎里,-393,70,463,469,627,0.7,蘇招治,無
高雄市橋頭區仕和里,-139,453,592,2735,3546,0.8,朱高成,無
高雄市橋頭區仕豐里,-492,361,853,1986,2583,0.8,周才淵,民主進步黨
高雄市橋頭區仕隆里,-159,228,387,1625,2155,0.8,馬兆賢,無
高雄市橋頭區德松里,-12,199,211,1118,1444,0.8,何東喜,民主進步黨
高雄市橋頭區新莊里,850,1187,337,4315,5880,0.7,朱正清,無
高雄市橋頭區東林里,-334,261,595,1634,2172,0.8,陸見青,無
高雄市橋頭區橋南里,-422,168,590,1133,1474,0.8,蘇道明,無
高雄市橋頭區橋頭里,-439,208,647,1151,1532,0.8,余美蓮,無
高雄市橋頭區甲北里,-329,340,669,1650,2346,0.7,李林足素,無
高雄市橋頭區甲南里,-380,271,651,1748,2354,0.7,方明賢,無
高雄市橋頭區白樹里,-31,412,443,2341,3173,0.7,吳安祥,無
高雄市橋頭區筆秀里,-261,159,420,1102,1452,0.8,李庭珮,無
高雄市橋頭區芋寮里,-369,132,501,869,1137,0.8,凌陽賢,民主進步黨
高雄市橋頭區西林里,-321,128,449,1009,1306,0.8,吳建豐,無
高雄市橋頭區頂鹽里,-375,218,593,1368,1851,0.7,顏家進,無
高雄市永安區保寧里,-384,373,757,1822,2548,0.7,陳文印,無
高雄市永安區新港里,-130,308,438,1886,2708,0.7,蘇月鳳,無
高雄市永安區永安里,-483,136,619,839,1199,0.7,林水雹,無
高雄市永安區永華里,-477,205,682,1306,1813,0.7,林明春,無
高雄市永安區維新里,96,458,362,2350,3310,0.7,蔣福山,無
高雄市永安區鹽田里,-161,33,194,278,401,0.7,柯男烈,無
高雄市湖內區中賢里,-281,308,589,1866,2723,0.7,王阮寶雲,無
高雄市湖內區公舘里,-346,327,673,1618,2206,0.7,林蘇麗雲,無
高雄市湖內區劉家里,-443,135,578,1017,1449,0.7,劉宏添,無
高雄市湖內區大湖里,168,447,279,2348,3251,0.7,洪添謀,無
高雄市湖內區太爺里,-235,82,317,561,746,0.8,蘇宗傑,無
高雄市湖內區忠興里,-232,125,357,860,1239,0.7,邱韋能,無
高雄市湖內區文賢里,-322,71,393,448,602,0.7,林金坤,無
高雄市湖內區海埔里,-83,210,293,1195,1694,0.7,杜丙戍,無
高雄市湖內區海山里,-511,47,558,367,519,0.7,劉寶霞,無
高雄市湖內區湖內里,91,530,439,2662,3735,0.7,林志聰,無
高雄市湖內區湖東里,57,347,290,1813,2683,0.7,黃太平,無
高雄市湖內區田尾里,-347,167,514,1034,1411,0.7,謝秋影,無
高雄市湖內區葉厝里,-39,320,359,1872,2608,0.7,葉進昌,無
高雄市湖內區逸賢里,-440,71,511,384,553,0.7,林秀卿,無
高雄市燕巢區南燕里,6,468,462,2616,3841,0.7,龔榮源,無
高雄市燕巢區安招里,279,361,82,2335,3234,0.7,黃清吉,中國國民黨
高雄市燕巢區尖山里,-455,93,548,767,1105,0.7,何旭信,無
高雄市燕巢區東燕里,-268,265,533,1625,2252,0.7,吳振武,無
高雄市燕巢區橫山里,-122,185,307,1207,1782,0.7,陳隆盛,無
高雄市燕巢區深水里,-355,206,561,1548,2332,0.7,林明雄,無
高雄市燕巢區瓊林里,-265,263,528,1488,2022,0.7,張舜傑,無
高雄市燕巢區西燕里,-119,431,550,2299,3210,0.7,李秀英,無
高雄市燕巢區角宿里,-89,352,441,1989,2657,0.7,莊璨隆,無
高雄市燕巢區金山里,-123,41,164,299,425,0.7,林順輔,無
高雄市燕巢區鳳雄里,-424,247,671,1639,2367,0.7,陳明發,無
高雄市田寮區七星里,-456,38,494,395,585,0.7,呂革明,無
高雄市田寮區三和里,-158,24,182,188,318,0.6,林正春,無
高雄市田寮區南安里,-82,71,153,615,943,0.7,葉正諒,無
高雄市田寮區古亭里,-184,23,207,305,454,0.7,許英豪,無
高雄市田寮區大同里,-294,24,318,217,351,0.6,王榮華,無
高雄市田寮區崇德里,-384,105,489,640,885,0.7,陳金城,無
高雄市田寮區新興里,-199,91,290,796,1120,0.7,何百農,無
高雄市田寮區田寮里,-179,11,190,223,343,0.7,連于萱,無
高雄市田寮區西德里,-355,57,412,485,729,0.7,黃萬春,無
高雄市田寮區鹿埔里,-165,17,182,242,342,0.7,楊美芬,無
高雄市甲仙區和安里,-292,43,335,399,639,0.6,李新福,中國國民黨
高雄市甲仙區大田里,-210,109,319,842,1461,0.6,張琪,無
高雄市甲仙區寶隆里,-300,34,334,370,616,0.6,連英朱,無
高雄市甲仙區小林里,-344,36,380,281,488,0.6,潘世彬,無
高雄市甲仙區東安里,-123,48,171,225,420,0.5,游新儀,中國國民黨
高雄市甲仙區西安里,-436,67,503,570,826,0.7,范姮枝,中國國民黨
高雄市甲仙區關山里,-390,29,419,373,560,0.7,林欣郿,無
高雄市美濃區中圳里,-144,205,349,1374,2010,0.7,黃其添,無
高雄市美濃區中壇里,-212,146,358,933,1423,0.7,楊秋田,無
高雄市美濃區合和里,-208,171,379,1245,1928,0.6,林榮增,無
高雄市美濃區吉和里,-277,144,421,912,1306,0.7,黃文梅,無
高雄市美濃區吉東里,-181,166,347,1130,1693,0.7,黃新華,無
高雄市美濃區吉洋里,-156,140,296,1154,1743,0.7,曾順昌,無
高雄市美濃區廣德里,-262,154,416,1151,1773,0.6,黃沛文,無
高雄市美濃區廣林里,-191,101,292,863,1365,0.6,傅兆鎮,無
高雄市美濃區德興里,-463,135,598,970,1392,0.7,黃建雄,無
高雄市美濃區東門里,-264,120,384,957,1489,0.6,羅文俊,無
高雄市美濃區泰安里,-100,192,292,1039,1515,0.7,邱國維,無
高雄市美濃區清水里,-174,145,319,1111,1623,0.7,張金發,無
高雄市美濃區瀰濃里,-183,202,385,1410,2180,0.6,林仁興,無
高雄市美濃區獅山里,-331,187,518,1591,2363,0.7,鍾明福,無
高雄市美濃區祿興里,-460,307,767,1988,2962,0.7,劉昭宏,無
高雄市美濃區福安里,-5,207,212,1616,2459,0.7,鍾銘安,無
高雄市美濃區興隆里,-355,45,400,358,543,0.7,黃耀榮,無
高雄市美濃區龍山里,-390,160,550,1326,2015,0.7,温源興,無
高雄市美濃區龍肚里,-419,90,509,893,1323,0.7,邱連發,無
高雄市苓雅區中正里,-80,347,427,1975,2631,0.8,胡維成,中國國民黨
高雄市苓雅區五權里,-292,248,540,1651,2157,0.8,陳玉環,無
高雄市苓雅區五福里,-324,347,671,2509,3470,0.7,邱瑞祥,民主進步黨
高雄市苓雅區人和里,-218,175,393,1152,1640,0.7,林志田,民主進步黨
高雄市苓雅區仁政里,-511,125,636,893,1203,0.7,黃裕庭,無
高雄市苓雅區光華里,-297,62,359,477,670,0.7,吳照鉠,民主進步黨
高雄市苓雅區凱旋里,-285,253,538,1511,2044,0.7,錢雲徽,中國國民黨
高雄市苓雅區博仁里,-239,64,303,458,637,0.7,陳奇伯,中國國民黨
高雄市苓雅區同慶里,-196,269,465,1487,1980,0.8,高文明,無
高雄市苓雅區和煦里,-331,227,558,1373,1837,0.7,莊財通,無
高雄市苓雅區城北里,-20,192,212,1121,1545,0.7,王宏嘉,無
高雄市苓雅區城東里,-65,221,286,1258,1800,0.7,史妮可,無
高雄市苓雅區城西里,-248,2,250,13,19,0.7,朱育賢,無
高雄市苓雅區奏捷里,-147,183,330,1106,1472,0.8,林豐富,民主進步黨
高雄市苓雅區安祥里,-357,321,678,1988,2696,0.7,董輝章,中國國民黨
高雄市苓雅區尚義里,-190,167,357,1115,1507,0.7,曾蔡玉燕,中國國民黨
高雄市苓雅區廣澤里,-145,181,326,1222,1639,0.7,沈秀美,無
高雄市苓雅區建軍里,-170,141,311,805,1109,0.7,黄錫聰,無
高雄市苓雅區意誠里,-17,388,405,2356,3652,0.6,蕭長保,中國國民黨
高雄市苓雅區文昌里,-283,384,667,2538,3512,0.7,林博文,民主進步黨
高雄市苓雅區日中里,-121,220,341,1487,2000,0.7,黃浚旂,無
高雄市苓雅區普天里,-161,413,574,2406,3243,0.7,李文豪,無
高雄市苓雅區普照里,-247,298,545,2141,2904,0.7,蔡政宏,無
高雄市苓雅區晴朗里,66,251,185,1372,2643,0.5,孫永吉,無
高雄市苓雅區朝陽里,-168,147,315,990,1359,0.7,丁文瑞,無
高雄市苓雅區林中里,-229,282,511,1874,2641,0.7,杜佳福,無
高雄市苓雅區林南里,-142,273,415,1932,2670,0.7,黃旭煌,無
高雄市苓雅區林圍里,-345,291,636,1642,2148,0.8,羅莉萍,中國國民黨
高雄市苓雅區林安里,-131,198,329,1086,1482,0.7,張列綱,無
高雄市苓雅區林富里,-176,295,471,1650,2168,0.8,林進安,無
高雄市苓雅區林德里,-159,211,370,1225,1680,0.7,翁正財,無
高雄市苓雅區林榮里,-23,485,508,2626,3633,0.7,王文祿,無
高雄市苓雅區林泉里,-153,205,358,1312,1748,0.8,翁烔訓,中國國民黨
高雄市苓雅區林興里,-155,120,275,821,1180,0.7,黃培裕,民主進步黨
高雄市苓雅區林華里,-181,258,439,1852,2481,0.7,張家偉,民主進步黨
高雄市苓雅區林西里,-269,147,416,1038,1475,0.7,方琪麟,中國國民黨
高雄市苓雅區林貴里,-116,211,327,1280,1706,0.8,黃清溪,無
高雄市苓雅區林靖里,-65,173,238,1115,1502,0.7,蔡温怡,無
高雄市苓雅區正仁里,-352,321,673,1696,2342,0.7,黃敏捷,無
高雄市苓雅區正大里,-24,595,619,3394,4814,0.7,陳錦宏,無
高雄市苓雅區正心里,13,394,381,2460,3369,0.7,陳顏秋萍,中國國民黨
高雄市苓雅區正文里,-249,324,573,1793,2395,0.7,莊文忠,無
高雄市苓雅區正義里,-332,266,598,1700,2246,0.8,劉銀連,中國國民黨
高雄市苓雅區正言里,-341,223,564,1412,1938,0.7,古金川,無
高雄市苓雅區正道里,-144,462,606,2822,3965,0.7,楊舜堡,無
高雄市苓雅區民主里,22,493,471,2940,4035,0.7,陳文程,無
高雄市苓雅區永康里,-10,252,262,1459,1999,0.7,陳瑛定,無
高雄市苓雅區田西里,-396,163,559,934,1266,0.7,郭國民,中國國民黨
高雄市苓雅區福人里,-281,196,477,1333,1900,0.7,曾黃金華,無
高雄市苓雅區福南里,-96,172,268,1193,1642,0.7,蘇文安,無
高雄市苓雅區福地里,-387,262,649,1725,2426,0.7,蔡添財,無
高雄市苓雅區福壽里,-184,154,338,1014,1374,0.7,郭寬洲,民主進步黨
高雄市苓雅區福居里,-221,245,466,1757,2477,0.7,吳明憲,民主進步黨
高雄市苓雅區福康里,-319,191,510,1246,1732,0.7,陳信吾,無
高雄市苓雅區福東里,-445,284,729,1741,2423,0.7,劉呂燕芬,無
高雄市苓雅區福海里,-465,125,590,733,1007,0.7,廖富男,中國國民黨
高雄市苓雅區福祥里,-411,168,579,896,1239,0.7,劉榮福,民主進步黨
高雄市苓雅區福西里,-273,185,458,1269,1776,0.7,黃正德,無
高雄市苓雅區福隆里,-265,309,574,1913,2672,0.7,郭彌堅,民主進步黨
高雄市苓雅區美田里,-391,120,511,754,1073,0.7,吳金對,無
高雄市苓雅區苓中里,-249,193,442,1157,1548,0.7,吳敏寬,無
高雄市苓雅區苓昇里,-228,120,348,792,1123,0.7,陳文喜,無
高雄市苓雅區苓東里,-58,136,194,952,1368,0.7,楊玉鳳,無
高雄市苓雅區苓洲里,-87,169,256,1064,1532,0.7,吳弘宜,中國國民黨
高雄市苓雅區苓雅里,-255,151,406,977,1382,0.7,郭釗琦,無
高雄市苓雅區英明里,-378,190,568,1252,1718,0.7,黃秀靜,無
高雄市苓雅區華堂里,-118,299,417,2021,2858,0.7,曾興德,無
高雄市苓雅區衛武里,-220,199,419,1324,1826,0.7,邱秀迷,無
高雄市苓雅區鼓中里,-400,82,482,633,880,0.7,郭明鴻,無
高雄市茂林區多納里,-411,47,458,351,490,0.7,羅耀明,中國國民黨
高雄市茂林區茂林里,-543,88,631,532,711,0.7,"田振弘 Kukui‧Pakadavy",中國國民黨
高雄市茂林區萬山里,-298,24,322,277,361,0.8,蔡正男,無
高雄市茄萣區保定里,-457,264,721,1564,2235,0.7,郭淑芬,無
高雄市茄萣區光定里,-185,90,275,575,871,0.7,林高華,無
高雄市茄萣區吉定里,-620,129,749,794,1088,0.7,薛賢成,無
高雄市茄萣區和協里,-404,122,526,836,1249,0.7,吳進發,無
高雄市茄萣區嘉安里,-270,107,377,674,961,0.7,林陳麗雯,無
高雄市茄萣區嘉定里,-248,130,378,913,1329,0.7,歐清信,無
高雄市茄萣區嘉樂里,-285,223,508,1501,2174,0.7,郭松南,無
高雄市茄萣區嘉泰里,-278,115,393,826,1211,0.7,鄭君男,無
高雄市茄萣區嘉福里,-523,125,648,755,1142,0.7,吳財榮,無
高雄市茄萣區嘉賜里,-145,449,594,2572,3697,0.7,葉宏信,民主進步黨
高雄市茄萣區大定里,-260,145,405,915,1325,0.7,薛金成,無
高雄市茄萣區崎漏里,55,530,475,3124,4709,0.7,邱美麗,無
高雄市茄萣區白雲里,-86,168,254,933,1242,0.8,郭麗華,無
高雄市茄萣區福德里,-486,142,628,996,1346,0.7,陳茂生,無
高雄市茄萣區萬福里,-379,86,465,560,825,0.7,蘇永南,無
高雄市路竹區三爺里,-507,134,641,800,1090,0.7,康庭琰,無
高雄市路竹區下坑里,-37,299,336,1546,2101,0.7,王金水,無
高雄市路竹區北嶺里,-561,161,722,1096,1470,0.7,黃松德,無
高雄市路竹區後鄉里,-328,244,572,1219,1618,0.8,金宜頵,無
高雄市路竹區文北里,-87,429,516,2088,2855,0.7,陳慶宗,無
高雄市路竹區文南里,-470,244,714,1242,1624,0.8,許明嘉,無
高雄市路竹區新達里,-484,203,687,1100,1495,0.7,杜明昌,無
高雄市路竹區甲北里,-337,377,714,1890,2650,0.7,王錦祥,無
高雄市路竹區甲南里,-334,325,659,1834,2562,0.7,黃吉松,無
高雄市路竹區社中里,-267,97,364,551,801,0.7,魏林寶菊,無
高雄市路竹區社南里,219,483,264,3286,4456,0.7,石永昌,中國國民黨
高雄市路竹區社東里,-341,285,626,1624,2162,0.8,蘇鑫,無
高雄市路竹區社西里,-303,227,530,1166,1614,0.7,馬旭來,無
高雄市路竹區竹南里,42,303,261,1818,2542,0.7,高月英,無
高雄市路竹區竹園里,-185,291,476,1567,2226,0.7,辛瑞賢,無
高雄市路竹區竹東里,-110,482,592,2551,3375,0.8,程啓龍,無
高雄市路竹區竹滬里,-54,362,416,1685,2472,0.7,劉崑芳,無
高雄市路竹區竹西里,-243,264,507,1511,2061,0.7,黃李月施,無
高雄市路竹區頂寮里,-573,176,749,1019,1407,0.7,黃居賢,無
高雄市路竹區鴨寮里,-263,169,432,958,1281,0.7,蘇清吉,無
高雄市那瑪夏區南沙魯里,-348,25,373,336,466,0.7,劉陳玉梅,無
高雄市那瑪夏區瑪雅里,-274,56,330,422,623,0.7,許利滿,無
高雄市那瑪夏區達卡努瓦里,-350,91,441,728,1328,0.5,朱子亮,無
高雄市阿蓮區中路里,-423,183,606,1361,1894,0.7,林永信,無
高雄市阿蓮區南蓮里,8,377,369,2017,2859,0.7,林首相,無
高雄市阿蓮區和蓮里,-370,216,586,1251,1722,0.7,陳秀裡,無
高雄市阿蓮區峯山里,-573,111,684,831,1167,0.7,鄭鴻哖,無
高雄市阿蓮區崗山里,-375,85,460,533,763,0.7,吳尚儒,無
高雄市阿蓮區復安里,-261,115,376,848,1196,0.7,何榮華,中國國民黨
高雄市阿蓮區清蓮里,-205,281,486,1746,2505,0.7,陳伯温,無
高雄市阿蓮區港後里,96,295,199,1804,2525,0.7,鄭文能,無
高雄市阿蓮區玉庫里,-441,133,574,968,1382,0.7,鄭明聰,無
高雄市阿蓮區石安里,-373,172,545,1141,1593,0.7,蔡寬意,無
高雄市阿蓮區阿蓮里,-56,564,620,3235,4661,0.7,黃靖娟,無
高雄市阿蓮區青旗里,-214,134,348,760,1120,0.7,陳文曉,無
高雄市鳥松區仁美里,119,754,635,4785,6688,0.7,吳家儒,無
高雄市鳥松區坔埔里,-228,431,659,2650,3542,0.7,黃永順,民主進步黨
高雄市鳥松區夢裡里,124,669,545,3955,5367,0.7,陳萬丁,無
高雄市鳥松區大竹里,-350,20,370,134,184,0.7,蔡榮瑞,無
高雄市鳥松區大華里,652,1267,615,7610,10058,0.8,蔡美蘭,中國國民黨
高雄市鳥松區華美里,-288,448,736,2824,3875,0.7,邱宏棋,無
高雄市鳥松區鳥松里,680,1155,475,6551,9371,0.7,謝唐欽,無
高雄市鳳山區一甲里,11,354,343,2332,3334,0.7,蔡瑋誠,無
高雄市鳳山區三民里,-435,140,575,804,1076,0.7,黃榮貴,無
高雄市鳳山區中和里,-276,394,670,2383,3193,0.7,張簡進興,無
高雄市鳳山區中崙里,-412,214,626,1142,1627,0.7,林齊諒,無
高雄市鳳山區中榮里,-246,562,808,3049,4387,0.7,劉秀美,無
高雄市鳳山區中正里,-71,462,533,2957,4057,0.7,鄒家駿,中國國民黨
高雄市鳳山區中民里,-1,560,561,3305,4684,0.7,黃金利,無
高雄市鳳山區二甲里,-261,600,861,3475,4754,0.7,黃昭雄,無
高雄市鳳山區五福里,-281,236,517,1437,1959,0.7,王劉煌,無
高雄市鳳山區保安里,572,992,420,4952,6603,0.7,謝昆政,無
高雄市鳳山區光明里,-453,154,607,886,1262,0.7,王俊富,無
高雄市鳳山區北門里,-112,436,548,2702,3777,0.7,謝秀霞,民主進步黨
高雄市鳳山區協和里,-131,384,515,2197,2932,0.7,羅美滿,無
高雄市鳳山區南和里,-398,302,700,2009,2792,0.7,李錦珠,民主進步黨
高雄市鳳山區南成里,781,1355,574,6851,9318,0.7,楊居財,無
高雄市鳳山區南興里,-344,100,444,633,846,0.7,廖春花,無
高雄市鳳山區和德里,-155,454,609,2033,2762,0.7,吳金池,無
高雄市鳳山區和興里,124,549,425,3274,4356,0.8,周春生,無
高雄市鳳山區善美里,372,720,348,4030,5784,0.7,張育臺,民主進步黨
高雄市鳳山區國光里,-267,252,519,1677,2360,0.7,呂岳霖,無
高雄市鳳山區國富里,-51,352,403,2011,2702,0.7,陳振沛,無
高雄市鳳山區國泰里,-201,374,575,2700,3801,0.7,黃昭清,無
高雄市鳳山區國隆里,-282,240,522,1786,2533,0.7,呂富貴,無
高雄市鳳山區埤頂里,25,696,671,4114,5683,0.7,謝順和,無
高雄市鳳山區大德里,-316,508,824,3255,4556,0.7,侯俊傑,無
高雄市鳳山區天興里,-275,398,673,2571,3570,0.7,郭秉鑫,無
高雄市鳳山區富榮里,-520,228,748,1155,1592,0.7,郭登臨,無
高雄市鳳山區富甲里,-89,237,326,1462,2083,0.7,王筱銜,無
高雄市鳳山區忠孝里,196,603,407,3872,5384,0.7,蔡美雪,無
高雄市鳳山區忠義里,48,615,567,3201,4309,0.7,李朝清,無
高雄市鳳山區忠誠里,-290,476,766,2470,3415,0.7,陳永壽,無
高雄市鳳山區成功里,-301,18,319,122,169,0.7,鄭美玉,無
高雄市鳳山區文山里,338,813,475,4414,6076,0.7,黃惠玲,民主進步黨
高雄市鳳山區文德里,555,1195,640,6424,8832,0.7,謝智華,無
高雄市鳳山區文福里,715,1405,690,6808,9205,0.7,余世善,無
高雄市鳳山區文英里,14,484,470,2542,3484,0.7,鄭鴻章,無
高雄市鳳山區文華里,317,1006,689,5785,7903,0.7,張嘉玲,無
高雄市鳳山區文衡里,-145,573,718,2867,3993,0.7,洪啟修,無
高雄市鳳山區新富里,59,491,432,3049,4198,0.7,李金福,無
高雄市鳳山區新強里,-86,581,667,3217,4293,0.7,李得勝,民主進步黨
高雄市鳳山區新樂里,-196,461,657,2318,3155,0.7,李滋宏,民主進步黨
高雄市鳳山區新武里,2,386,384,2099,2790,0.8,李戊琳,無
高雄市鳳山區新泰里,-71,594,665,3033,4166,0.7,歐諺霖,無
高雄市鳳山區新甲里,-202,422,624,2350,3224,0.7,柯寶凱,無
高雄市鳳山區新興里,-15,184,199,1166,3408,0.3,郭傅美金,無
高雄市鳳山區曹公里,-26,221,247,1360,1862,0.7,侯朝明,無
高雄市鳳山區東門里,-1,713,714,3943,5641,0.7,劉晋祥,無
高雄市鳳山區正義里,108,588,480,3588,4952,0.7,鄭洂汯,無
高雄市鳳山區武慶里,-280,349,629,1995,2724,0.7,張淑敏,無
高雄市鳳山區武松里,-74,305,379,1779,2544,0.7,戴惠敏,無
高雄市鳳山區武漢里,-85,487,572,2778,3955,0.7,蘇弘展,民主進步黨
高雄市鳳山區海光里,-460,344,804,1980,2744,0.7,鍾翠民,無
高雄市鳳山區海洋里,-14,520,534,2988,3985,0.7,蔡秀寶,無
高雄市鳳山區瑞竹里,-22,572,594,3648,5076,0.7,李美雲,中國國民黨
高雄市鳳山區瑞興里,-95,693,788,3589,4922,0.7,王玉蘭,中國國民黨
高雄市鳳山區生明里,-259,218,477,1423,1938,0.7,郭清竹,中國國民黨
高雄市鳳山區福祥里,-368,350,718,2209,3041,0.7,李安琪,無
高雄市鳳山區福興里,192,461,269,3053,4397,0.7,鄭陳麗珠,無
高雄市鳳山區福誠里,120,727,607,3816,5130,0.7,許德發,民主進步黨
高雄市鳳山區縣口里,-253,4,257,22,34,0.6,洪敏川,無
高雄市鳳山區縣衙里,-303,104,407,582,802,0.7,王鈴雅,中國國民黨
高雄市鳳山區老爺里,469,812,343,4929,6880,0.7,李菁雅,無
高雄市鳳山區興中里,-310,137,447,668,864,0.8,林天財,中國國民黨
高雄市鳳山區興仁里,-131,386,517,2340,3177,0.7,林曾桂花,無
高雄市鳳山區誠信里,-320,154,474,936,1325,0.7,蔡自謄,中國國民黨
高雄市鳳山區誠德里,-69,324,393,1788,2485,0.7,陳世寳,中國國民黨
高雄市鳳山區誠智里,-126,309,435,1784,2595,0.7,黃桂花,中國國民黨
高雄市鳳山區誠義里,-53,549,602,2847,3696,0.8,劉啓芳,中國國民黨
高雄市鳳山區過埤里,1457,2148,691,10083,14164,0.7,莫尚忠,無
高雄市鳳山區鎮北里,971,1651,680,7339,10407,0.7,趙志成,無
高雄市鳳山區鎮南里,101,480,379,2845,3936,0.7,楊三吉,民主進步黨
高雄市鳳山區鎮東里,-207,339,546,1739,2443,0.7,張簡裕芳,無
高雄市鳳山區鎮西里,90,594,504,3397,4599,0.7,李陳金治,無
高雄市鳳山區鳳崗里,-420,128,548,848,1150,0.7,董錦慧,中國國民黨
高雄市鳳山區鳳東里,299,800,501,4646,6325,0.7,蔡瑋寧,民主進步黨
高雄市鳳山區龍成里,-507,297,804,2119,2981,0.7,張芳瑋,無
高雄市鹽埕區中原里,-302,55,357,440,592,0.7,洪玄志,無
高雄市鹽埕區中山里,-429,156,585,948,1323,0.7,易明忠,無
高雄市鹽埕區光明里,-469,6,475,44,70,0.6,葛吉雄,無
高雄市鹽埕區南端里,-315,92,407,656,946,0.7,陳清標,無
高雄市鹽埕區博愛里,-351,45,396,482,657,0.7,林哲弘,無
高雄市鹽埕區壽星里,-578,115,693,872,1286,0.7,黃強,無
高雄市鹽埕區府北里,-10,200,210,1414,2000,0.7,莊世權,無
高雄市鹽埕區慈愛里,-178,34,212,262,372,0.7,呂佳穎,無
高雄市鹽埕區教仁里,-484,202,686,1436,1919,0.7,高陳文玲,無
高雄市鹽埕區新化里,-239,65,304,445,588,0.8,夏麗鳳,無
高雄市鹽埕區新樂里,-431,88,519,627,833,0.8,黃昭翔,無
高雄市鹽埕區新豐里,-216,86,302,598,818,0.7,郭蘇元,無
高雄市鹽埕區江南里,-201,44,245,416,602,0.7,蔡德龍,民主進步黨
高雄市鹽埕區江西里,-414,99,513,751,1045,0.7,鄭錫國,無
高雄市鹽埕區沙地里,-243,67,310,518,717,0.7,高健財,無
高雄市鹽埕區河濱里,-147,190,337,1170,1542,0.8,林德松,無
高雄市鹽埕區港都里,-345,81,426,774,1042,0.7,邱誌雲,民主進步黨
高雄市鹽埕區瀨南里,-305,49,354,432,591,0.7,邱有洧,無
高雄市鹽埕區育仁里,-278,65,343,558,786,0.7,葛有力,無
高雄市鹽埕區藍橋里,-258,166,424,955,1281,0.7,陳本興,中國國民黨
高雄市鹽埕區陸橋里,-362,111,473,785,1109,0.7,許梅娟,民主進步黨
高雄市鼓山區光化里,-323,122,445,869,1232,0.7,周國城,無
高雄市鼓山區光榮里,-23,375,398,2488,3401,0.7,葉文朗,無
高雄市鼓山區內惟里,-342,136,478,802,1114,0.7,林進發,無
高雄市鼓山區前峰里,-64,430,494,2903,3958,0.7,盧明惠,中國國民黨
高雄市鼓山區厚生里,-670,342,1012,2101,2871,0.7,歐瑞清,無
高雄市鼓山區哨船頭里,-221,100,321,696,984,0.7,楊宗正,無
高雄市鼓山區壽山里,-427,121,548,875,1290,0.7,陳進興,民主進步黨
高雄市鼓山區寶樹里,-369,111,480,831,1941,0.4,王登科,無
高雄市鼓山區山下里,-599,143,742,952,1285,0.7,杜文瑞,中國國民黨
高雄市鼓山區峰南里,-370,52,422,531,774,0.7,王宋金花,中國國民黨
高雄市鼓山區平和里,-314,356,670,2496,3335,0.7,陳玉芳,民主進步黨
高雄市鼓山區延平里,-250,71,321,550,734,0.7,洪蔡愛玉,無
高雄市鼓山區建國里,-62,287,349,1860,2438,0.8,許分薰,無
高雄市鼓山區忠正里,-163,392,555,2602,3591,0.7,洪吉祥,無
高雄市鼓山區惠安里,-367,122,489,763,1087,0.7,洪進成,無
高雄市鼓山區新民里,-554,92,646,709,973,0.7,洪宗郁,無
高雄市鼓山區明誠里,1421,2085,664,10426,14752,0.7,胡景森,中國國民黨
高雄市鼓山區桃源里,-333,53,386,409,552,0.7,李慶賢,無
高雄市鼓山區樹德里,-437,110,547,852,1120,0.8,黃武田,無
高雄市鼓山區正德里,-680,192,872,1441,1972,0.7,朱榮俊,中國國民黨
高雄市鼓山區民強里,-450,242,692,1861,2549,0.7,歐華美,無
高雄市鼓山區民族里,-587,155,742,1032,1338,0.8,朱春木,中國國民黨
高雄市鼓山區河邊里,-378,6,384,42,61,0.7,曾茂信,中國國民黨
高雄市鼓山區登山里,-295,64,359,425,633,0.7,許永堃,無
高雄市鼓山區綠川里,-388,130,518,984,1326,0.7,郭國華,無
高雄市鼓山區維生里,-447,109,556,846,1193,0.7,董錦昌,無
高雄市鼓山區自強里,-276,63,339,561,787,0.7,方紹義,中國國民黨
高雄市鼓山區興宗里,-520,100,620,875,1239,0.7,楊孟翰,無
高雄市鼓山區華豐里,-620,485,1105,2975,3986,0.7,黃明洲,中國國民黨
高雄市鼓山區裕興里,-494,418,912,2532,3407,0.7,曾榮發,中國國民黨
高雄市鼓山區裕豐里,-375,313,688,1969,2704,0.7,周恆功,中國國民黨
高雄市鼓山區雄峰里,-35,247,282,1338,1958,0.7,楊惠茵,中國國民黨
高雄市鼓山區麗興里,-306,85,391,657,953,0.7,王志斌,無
高雄市鼓山區鼓岩里,-357,100,457,777,1150,0.7,方國智,無
高雄市鼓山區鼓峰里,-197,253,450,1345,1910,0.7,麥克士,中國國民黨
高雄市鼓山區龍井里,-634,116,750,906,1265,0.7,周明吉,無
高雄市鼓山區龍子里,1752,2227,475,11497,15711,0.7,蘇彥傑,無
高雄市鼓山區龍水里,2731,3308,577,16567,22489,0.7,初學霖,民主進步黨
