村里,2024-2022,2024民眾黨,2022村里長得票,2024投票數,2024選舉人數,2024投票率,里長姓名,里長政黨
高雄市三民區力行里,-261,109,370,787,1000,0.8,李水池,中國國民黨
高雄市三民區十全里,-382,190,572,1205,1618,0.7,洪能通,無
高雄市三民區十美里,-432,89,521,654,877,0.7,蔡灯能,民主進步黨
高雄市三民區千北里,-393,98,491,733,974,0.8,黃林麗香,無
高雄市三民區千歲里,-467,113,580,802,1081,0.7,許婉羚,無
高雄市三民區千秋里,-372,172,544,1318,1893,0.7,蔡文和,無
高雄市三民區博惠里,-697,382,1079,2753,3777,0.7,洪耀斌,無
高雄市三民區博愛里,-482,137,619,811,1113,0.7,鍾秋美,無
高雄市三民區同德里,-609,264,873,1915,2538,0.8,陳清源,無
高雄市三民區安吉里,-883,608,1491,3274,4558,0.7,王明文,無
高雄市三民區安和里,-894,300,1194,1839,2436,0.8,傅秋陽,民主進步黨
高雄市三民區安宜里,-1033,334,1367,2254,2957,0.8,周黃俊宇,無
高雄市三民區安寧里,-588,169,757,1189,1771,0.7,郭海定,民主進步黨
高雄市三民區安康里,-427,150,577,936,1445,0.6,孫聖雄,無
高雄市三民區安東里,-664,391,1055,2285,2986,0.8,林添祥,無
高雄市三民區安泰里,-911,403,1314,2565,3547,0.7,謝明學,無
高雄市三民區安生里,-274,211,485,1207,1621,0.7,余許淑女,無
高雄市三民區安發里,-599,486,1085,3001,4203,0.7,許峻溢,無
高雄市三民區安邦里,-966,452,1418,2675,3600,0.7,黃崑山,無
高雄市三民區寶中里,-697,320,1017,2009,2752,0.7,任憲慶,中國國民黨
高雄市三民區寶國里,-561,1028,1589,5313,7362,0.7,黃兆華,民主進步黨
高雄市三民區寶安里,-1079,831,1910,4810,6748,0.7,黃柏澤,中國國民黨
高雄市三民區寶德里,-1011,582,1593,3444,4795,0.7,潘進派,民主進步黨
高雄市三民區寶慶里,-381,307,688,1864,2617,0.7,陳昱昌,無
高雄市三民區寶業里,-1524,832,2356,4259,5718,0.7,林煥然,民主進步黨
高雄市三民區寶民里,-869,402,1271,2156,3027,0.7,陳詩椿,無
高雄市三民區寶泰里,-531,359,890,1838,2635,0.7,黃仲霖,民主進步黨
高雄市三民區寶獅里,-1183,449,1632,2490,3399,0.7,林昆明,無
高雄市三民區寶玉里,-909,1121,2030,5663,7765,0.7,黃昱椉,無
高雄市三民區寶珠里,-1104,592,1696,3573,6616,0.5,陳榮增,民主進步黨
高雄市三民區寶盛里,-473,603,1076,3476,4684,0.7,任天霸,無
高雄市三民區寶興里,-836,804,1640,4676,6398,0.7,許慶銘,無
高雄市三民區寶華里,-881,403,1284,2213,3016,0.7,李清樺,無
高雄市三民區寶龍里,-1568,442,2010,2919,3944,0.7,黃美琴,無
高雄市三民區川東里,-505,106,611,813,1167,0.7,李明海,無
高雄市三民區建東里,-302,123,425,733,1146,0.6,陳建藏,無
高雄市三民區德仁里,-638,200,838,1283,1772,0.7,袁碧嬌,民主進步黨
高雄市三民區德北里,-373,265,638,1568,2154,0.7,李仁祥,無
高雄市三民區德智里,-359,203,562,1526,1994,0.8,李明同,民主進步黨
高雄市三民區德東里,-344,83,427,564,735,0.8,許玉秀,無
高雄市三民區德行里,-371,93,464,785,1031,0.8,郭麗香,無
高雄市三民區德西里,-366,365,731,1414,1968,0.7,林財旺,無
高雄市三民區本上里,-916,620,1536,3301,4443,0.7,詹鶴,無
高雄市三民區本元里,-834,644,1478,3699,4945,0.7,沈建宏,無
高雄市三民區本和里,-2079,926,3005,5054,6931,0.7,陳文旗,無
高雄市三民區本安里,-310,588,898,3141,4221,0.7,林辛福,中國國民黨
高雄市三民區本揚里,-874,939,1813,5287,7062,0.7,陳證閎,無
高雄市三民區本文里,-440,138,578,759,1050,0.7,郭和成,民主進步黨
高雄市三民區本武里,-290,197,487,1217,1651,0.7,吳阿吉,民主進步黨
高雄市三民區本館里,-2622,1043,3665,5954,8231,0.7,簡明鎮,無
高雄市三民區正興里,-1392,1670,3062,8247,11718,0.7,沈秀玲,民主進步黨
高雄市三民區正順里,-891,476,1367,2693,3689,0.7,黃冠惠,無
高雄市三民區民享里,-373,175,548,1383,1836,0.8,吳慶東,無
高雄市三民區港新里,-132,157,289,1078,1404,0.8,蘇麗玉,無
高雄市三民區港東里,-554,116,670,904,1319,0.7,張士賢,無
高雄市三民區港西里,-277,65,342,509,729,0.7,閩興傳,民主進步黨
高雄市三民區灣中里,-797,608,1405,3520,5191,0.7,楊宏明,無
高雄市三民區灣利里,-951,271,1222,2154,2962,0.7,郭峻毅,民主進步黨
高雄市三民區灣勝里,-658,161,819,1306,1807,0.7,陳金櫃,民主進步黨
高雄市三民區灣子里,-777,456,1233,2715,3850,0.7,方相茗,無
高雄市三民區灣復里,-1031,425,1456,2434,3429,0.7,吳國清,無
高雄市三民區灣愛里,-412,302,714,1888,2855,0.7,邱清勳,無
高雄市三民區灣成里,-635,393,1028,1930,2780,0.7,黃文良,無
高雄市三民區灣興里,-376,205,581,1349,1808,0.7,張文青,無
高雄市三民區灣華里,-396,330,726,1792,2528,0.7,高素女,中國國民黨
高雄市三民區立德里,-298,121,419,814,1126,0.7,林平長,中國國民黨
高雄市三民區立業里,-335,91,426,619,864,0.7,陳姵羽,無
高雄市三民區立誠里,-236,60,296,494,654,0.8,陳永進,中國國民黨
高雄市三民區精華里,-504,141,645,1069,1440,0.7,何佳憲,民主進步黨
高雄市三民區興德里,-394,238,632,1375,1883,0.7,陳國欽,無
高雄市三民區裕民里,-259,164,423,882,1227,0.7,陳水榮,無
高雄市三民區豐裕里,-517,228,745,1577,2250,0.7,謝錫元,無
高雄市三民區達仁里,-480,167,647,1000,1340,0.7,邱添富,民主進步黨
高雄市三民區達勇里,-190,95,285,626,878,0.7,李少緯,無
高雄市三民區達德里,-462,135,597,923,1209,0.8,陳國枝,無
高雄市三民區達明里,-629,143,772,1070,1472,0.7,張簡王玉珠,民主進步黨
高雄市三民區長明里,-340,107,447,699,982,0.7,林練丁,無
高雄市三民區鳳北里,-501,129,630,929,1234,0.8,鄭健村,無
高雄市三民區鳳南里,-315,114,429,707,964,0.7,王進祿,無
高雄市三民區鼎中里,-1034,484,1518,2783,3765,0.7,李水發,無
高雄市三民區鼎力里,-1135,519,1654,2846,3944,0.7,沈巽榮,無
高雄市三民區鼎強里,-791,307,1098,1891,2669,0.7,林國石,無
高雄市三民區鼎泰里,-6349,2799,9148,15013,20625,0.7,張吉雄,無
高雄市三民區鼎盛里,-906,991,1897,5209,7339,0.7,謝有清,民主進步黨
高雄市三民區鼎西里,-1698,935,2633,4946,6980,0.7,姚素眞,民主進步黨
高雄市三民區鼎金里,-1129,454,1583,2694,3913,0.7,高豐麟,無
高雄市仁武區中華里,-564,182,746,1079,1563,0.7,林志榮,民主進步黨
高雄市仁武區五和里,-370,772,1142,3772,5351,0.7,許有長,無
高雄市仁武區仁和里,-683,438,1121,2349,3200,0.7,鄭諭澤,無
高雄市仁武區仁慈里,-327,400,727,2219,2880,0.8,洪月琴,民主進步黨
高雄市仁武區仁武里,-1846,677,2523,3625,5377,0.7,劉俊彥,無
高雄市仁武區仁福里,-391,64,455,557,825,0.7,朱興,無
高雄市仁武區八卦里,-1592,2929,4521,13803,19278,0.7,謝秋江,無
高雄市仁武區大灣里,-876,665,1541,3482,4828,0.7,謝瑋原,民主進步黨
高雄市仁武區後安里,-803,266,1069,1784,2473,0.7,黃榮輝,無
高雄市仁武區文武里,-903,1236,2139,6633,9199,0.7,蔣明印,民主進步黨
高雄市仁武區灣內里,-2149,1154,3303,5917,8230,0.7,鄭文輝,民主進步黨
高雄市仁武區烏林里,-832,412,1244,2321,3556,0.7,林文斌,民主進步黨
高雄市仁武區竹後里,-575,217,792,1589,2196,0.7,黃常志,無
高雄市仁武區考潭里,-525,282,807,1866,2548,0.7,蔡德明,無
高雄市仁武區赤山里,-1096,1030,2126,5145,6978,0.7,謝青原,民主進步黨
高雄市仁武區高楠里,-754,486,1240,2217,3004,0.7,李志能,無
高雄市內門區三平里,-266,56,322,389,604,0.6,洪生業,無
高雄市內門區中埔里,-226,39,265,363,514,0.7,謝清雄,無
高雄市內門區光興里,-215,71,286,431,616,0.7,王士訓,無
高雄市內門區內南里,-137,34,171,249,381,0.7,沈芳昌,無
高雄市內門區內東里,-302,46,348,508,713,0.7,陳明章,無
高雄市內門區內興里,-215,29,244,352,572,0.6,力永信,無
高雄市內門區內豊里,-526,85,611,765,1112,0.7,龔飛盛,無
高雄市內門區內門里,-461,79,540,625,896,0.7,蔡瓊鳳,無
高雄市內門區木柵里,-270,40,310,370,556,0.7,机素勤,無
高雄市內門區東埔里,-170,43,213,302,458,0.7,張錦泉,無
高雄市內門區永吉里,-144,23,167,248,404,0.6,李永坤,無
高雄市內門區永富里,-410,70,480,602,926,0.7,蒙勝南,無
高雄市內門區永興里,-121,28,149,240,370,0.6,陳順良,無
高雄市內門區溝坪里,-292,66,358,531,877,0.6,謝振明,無
高雄市內門區瑞山里,-139,21,160,206,302,0.7,黄淑玲,無
高雄市內門區石坑里,-179,43,222,312,477,0.7,劉文斌,無
高雄市內門區觀亭里,-611,158,769,1102,1588,0.7,許志芳,無
高雄市內門區金竹里,-268,36,304,401,603,0.7,林熾杉,無
高雄市六龜區中興里,-222,118,340,843,1354,0.6,陳信景,無
高雄市六龜區六龜里,-243,54,297,468,894,0.5,邱國輝,無
高雄市六龜區大津里,-84,30,114,210,291,0.7,林文察,無
高雄市六龜區寶來里,-260,50,310,478,823,0.6,沈振揚,無
高雄市六龜區文武里,-366,92,458,746,1321,0.6,鍾達煌,無
高雄市六龜區新威里,-211,52,263,430,675,0.6,邱民棟,無
高雄市六龜區新寮里,-289,38,327,401,596,0.7,朱玉雲,無
高雄市六龜區新發里,-340,52,392,470,880,0.5,劉俊麟,無
高雄市六龜區新興里,-260,51,311,381,626,0.6,邱瑞明,無
高雄市六龜區義寶里,-237,69,306,593,954,0.6,鍾啟鴻,無
高雄市六龜區興龍里,-310,34,344,407,742,0.5,張榮華,無
高雄市六龜區荖濃里,-256,90,346,708,1305,0.5,陳俊福,無
高雄市前金區三川里,-106,136,242,688,901,0.8,莊晉勲,無
高雄市前金區北金里,-178,86,264,590,823,0.7,林福枝,無
高雄市前金區博孝里,-222,104,326,727,1004,0.7,方文杰,民主進步黨
高雄市前金區國民里,-192,94,286,648,935,0.7,謝明致,無
高雄市前金區後金里,-226,80,306,472,638,0.7,施孟均,無
高雄市前金區復元里,-374,93,467,749,1034,0.7,黃千豪,無
高雄市前金區文東里,-265,135,400,849,1130,0.8,黃崑光,無
高雄市前金區文西里,-321,113,434,706,972,0.7,賴勇村,無
高雄市前金區新生里,-1220,451,1671,2574,3548,0.7,康文展,無
高雄市前金區東金里,-389,82,471,672,961,0.7,謝仲箎,無
高雄市前金區林投里,-194,91,285,659,1092,0.6,李明峰,無
高雄市前金區榮復里,-396,103,499,777,1031,0.8,顏炳豪,無
高雄市前金區民生里,-181,6,187,33,45,0.7,黃博群,無
高雄市前金區社東里,-421,139,560,997,1423,0.7,黃玉英,無
高雄市前金區社西里,-359,154,513,850,1149,0.7,薛寶琴,無
高雄市前金區草江里,-357,178,535,966,1361,0.7,陳振琦,無
高雄市前金區長城里,-310,118,428,925,1334,0.7,李林春蘭,無
高雄市前金區長生里,-635,167,802,1190,1657,0.7,陳宗佐,無
高雄市前金區長興里,-427,154,581,859,1221,0.7,白宗正,無
高雄市前金區青山里,-380,214,594,1349,1922,0.7,江武吉,無
高雄市前鎮區仁愛里,-358,144,502,955,1294,0.7,楊朝雄,民主進步黨
高雄市前鎮區信德里,-771,224,995,1488,2138,0.7,李竣帆,無
高雄市前鎮區信義里,-486,130,616,949,1339,0.7,魏伯曆,民主進步黨
高雄市前鎮區前鎮里,-321,127,448,936,1271,0.7,許澤能,無
高雄市前鎮區平昌里,-214,73,287,457,687,0.7,高琅璋,民主進步黨
高雄市前鎮區平等里,-780,201,981,1427,2942,0.5,施長欽,民主進步黨
高雄市前鎮區建隆里,-301,142,443,970,1369,0.7,林得祿,中國國民黨
高雄市前鎮區復國里,-944,272,1216,1811,2483,0.7,呂建霖,民主進步黨
高雄市前鎮區德昌里,-410,184,594,1224,1768,0.7,李正義,無
高雄市前鎮區忠孝里,-455,423,878,2382,3279,0.7,陳宜汝,無
高雄市前鎮區忠純里,-1111,580,1691,3782,5147,0.7,艾台民,中國國民黨
高雄市前鎮區忠誠里,-843,202,1045,1365,1874,0.7,吳安美,中國國民黨
高雄市前鎮區振興里,-493,304,797,1716,2375,0.7,鍾明憲,無
高雄市前鎮區明孝里,-722,187,909,1230,1684,0.7,林浤澤,無
高雄市前鎮區明正里,-1143,601,1744,3515,4852,0.7,王春茂,民主進步黨
高雄市前鎮區明禮里,-588,173,761,1088,1544,0.7,莊志明,民主進步黨
高雄市前鎮區明義里,-474,247,721,1642,2201,0.7,張郁惠,無
高雄市前鎮區明道里,-382,101,483,780,1082,0.7,王進亨,民主進步黨
高雄市前鎮區民權里,-1327,471,1798,2864,3774,0.8,吳政昇,無
高雄市前鎮區瑞北里,-749,367,1116,2209,3124,0.7,陳眞玟,民主進步黨
高雄市前鎮區瑞南里,-1107,549,1656,3158,4359,0.7,張木春,民主進步黨
高雄市前鎮區瑞和里,-489,184,673,1288,1768,0.7,陳文人,民主進步黨
高雄市前鎮區瑞崗里,-587,273,860,1766,2405,0.7,洪金山,民主進步黨
高雄市前鎮區瑞平里,-707,415,1122,2472,3262,0.8,陳柏村,無
高雄市前鎮區瑞文里,-514,274,788,1634,2305,0.7,邱吉弘,無
高雄市前鎮區瑞昌里,-308,387,695,2167,2996,0.7,陳裕達,無
高雄市前鎮區瑞東里,-779,254,1033,1534,2186,0.7,許振稽,民主進步黨
高雄市前鎮區瑞祥里,-702,566,1268,3059,4239,0.7,劉美華,無
高雄市前鎮區瑞竹里,-490,390,880,1503,2031,0.7,許益彰,無
高雄市前鎮區瑞興里,-644,245,889,1751,2423,0.7,陳俊源,民主進步黨
高雄市前鎮區瑞華里,-1498,510,2008,3084,4201,0.7,蘇榮隆,無
高雄市前鎮區瑞西里,-587,251,838,1754,2462,0.7,蘇悦敏,民主進步黨
高雄市前鎮區瑞誠里,-592,329,921,1797,2475,0.7,林雪娥,無
高雄市前鎮區瑞豐里,-353,334,687,1845,2530,0.7,王森騰,民主進步黨
高雄市前鎮區瑞隆里,-879,385,1264,2329,3264,0.7,楊家鴻,無
高雄市前鎮區盛興里,-669,277,946,1788,2634,0.7,鍾鳳美,無
高雄市前鎮區盛豐里,-961,318,1279,2066,2951,0.7,王志濱,無
高雄市前鎮區竹中里,-707,392,1099,2409,3275,0.7,莊茂榮,無
高雄市前鎮區竹內里,-819,169,988,1064,1487,0.7,蘇慶忠,無
高雄市前鎮區竹北里,-286,349,635,1806,2469,0.7,楊吉村,無
高雄市前鎮區竹南里,-634,969,1603,4731,6503,0.7,蔡萬春,民主進步黨
高雄市前鎮區竹東里,-690,229,919,1404,2013,0.7,李春桂,無
高雄市前鎮區竹西里,-1469,491,1960,2873,3871,0.7,林金良,無
高雄市前鎮區興中里,-820,314,1134,1954,2877,0.7,狄金山,中國國民黨
高雄市前鎮區興仁里,-283,71,354,511,690,0.7,張秋敏,無
高雄市前鎮區興化里,-284,72,356,487,680,0.7,朱蘇來蔭,無
高雄市前鎮區興東里,-1701,716,2417,3908,5441,0.7,陳建銘,無
高雄市前鎮區興邦里,-909,215,1124,1208,1654,0.7,薛文龍,無
高雄市前鎮區良和里,-927,328,1255,2008,2719,0.7,陳瑞銓,中國國民黨
高雄市前鎮區草衙里,-3032,984,4016,6106,8923,0.7,李忠正,無
高雄市前鎮區西山里,-887,339,1226,2269,3144,0.7,陳天香,無
高雄市前鎮區西甲里,-354,210,564,1465,2039,0.7,潘石誠,民主進步黨
高雄市前鎮區鎮中里,-352,99,451,596,843,0.7,湯淑貞,無
高雄市前鎮區鎮北里,-487,118,605,816,1128,0.7,許昭福,無
高雄市前鎮區鎮昌里,-702,218,920,1402,1903,0.7,涂明鏡,無
高雄市前鎮區鎮東里,-749,182,931,1256,1623,0.8,蔡川士,無
高雄市前鎮區鎮榮里,-869,203,1072,1357,1960,0.7,黃士誠,民主進步黨
高雄市前鎮區鎮海里,-826,480,1306,2750,3848,0.7,蔡葉珍妮,民主進步黨
高雄市前鎮區鎮陽里,-307,102,409,685,962,0.7,鄭蔡秀燕,無
高雄市大寮區三隆里,-1137,534,1671,3262,4558,0.7,蕭國欽,民主進步黨
高雄市大寮區上寮里,-377,402,779,2170,3043,0.7,林慰卿,無
高雄市大寮區中庄里,-736,1407,2143,7481,10626,0.7,曾承豐,無
高雄市大寮區中興里,-967,593,1560,3869,5690,0.7,曾幸福,中國國民黨
高雄市大寮區內坑里,-837,639,1476,3679,5793,0.6,黃慶福,民主進步黨
高雄市大寮區前庄里,-528,255,783,1623,2229,0.7,陳金晚,中國國民黨
高雄市大寮區大寮里,-720,742,1462,4047,6033,0.7,蕭清翔,無
高雄市大寮區山頂里,-1380,936,2316,5051,7246,0.7,簡子銘,中國國民黨
高雄市大寮區後庄里,-1214,980,2194,5425,7588,0.7,鄭德文,無
高雄市大寮區忠義里,-85,119,204,769,1138,0.7,邴健鵬,中國國民黨
高雄市大寮區拷潭里,-464,135,599,925,1318,0.7,董鳳松,民主進步黨
高雄市大寮區新厝里,-421,175,596,1111,1614,0.7,張簡龍星,無
高雄市大寮區昭明里,-841,436,1277,2541,3722,0.7,張簡助昇,無
高雄市大寮區會社里,-951,647,1598,3881,6057,0.6,吳銀國,無
高雄市大寮區會結里,-476,115,591,773,1146,0.7,蔡金獅,中國國民黨
高雄市大寮區永芳里,-1886,811,2697,4662,6674,0.7,簡基成,無
高雄市大寮區江山里,-657,166,823,983,1340,0.7,許世川,無
高雄市大寮區溪寮里,-464,223,687,1472,1975,0.7,王基安,無
高雄市大寮區潮寮里,-881,358,1239,2323,3298,0.7,徐新生,無
高雄市大寮區琉球里,-1022,713,1735,3629,5017,0.7,郭秀品,無
高雄市大寮區義仁里,-907,157,1064,1195,1746,0.7,許明得,無
高雄市大寮區義和里,-824,248,1072,1591,2156,0.7,劉志陽,無
高雄市大寮區翁園里,-427,506,933,2900,3906,0.7,蔡順豐,無
高雄市大寮區過溪里,-487,316,803,1713,2439,0.7,陳秀英,無
高雄市大樹區三和里,-245,163,408,1115,1650,0.7,黃重信,無
高雄市大樹區久堂里,-1557,484,2041,2838,3988,0.7,張勝鋒,中國國民黨
高雄市大樹區九曲里,-1474,623,2097,3463,5106,0.7,潘德勝,中國國民黨
高雄市大樹區井腳里,-309,141,450,1051,1433,0.7,黃沼人,無
高雄市大樹區和山里,-382,90,472,663,957,0.7,吳順治,無
高雄市大樹區大坑里,-465,66,531,460,681,0.7,吳進雄,無
高雄市大樹區大樹里,-375,339,714,2027,2855,0.7,吳喜傳,無
高雄市大樹區姑山里,-293,93,386,691,952,0.7,王莊素真,無
高雄市大樹區小坪里,-408,130,538,892,1252,0.7,郭秀密,無
高雄市大樹區檨腳里,-773,258,1031,1748,2495,0.7,孫國憲,中國國民黨
高雄市大樹區水安里,-551,261,812,1656,2307,0.7,林正道,無
高雄市大樹區水寮里,-907,217,1124,1566,2115,0.7,史榮瑞,無
高雄市大樹區溪埔里,-310,140,450,999,1414,0.7,張耀珍,無
高雄市大樹區竹寮里,-1056,331,1387,1845,2591,0.7,鄭榕華,無
高雄市大樹區統嶺里,-262,42,304,438,626,0.7,許瑞楠,無
高雄市大樹區興山里,-353,138,491,963,1383,0.7,尹平成,無
高雄市大樹區興田里,-683,133,816,1298,1828,0.7,曾金益,中國國民黨
高雄市大樹區龍目里,-644,154,798,1157,1677,0.7,陳榮清,無
高雄市大社區三奶里,-549,297,846,1869,2597,0.7,許丁春,無
高雄市大社區中里里,-1101,375,1476,2220,3143,0.7,李旭仁,無
高雄市大社區保安里,-973,434,1407,2215,3075,0.7,林義萬,民主進步黨
高雄市大社區保社里,-556,447,1003,2313,3242,0.7,許清泉,民主進步黨
高雄市大社區嘉誠里,-331,89,420,576,855,0.7,侯景耀,無
高雄市大社區大社里,-527,590,1117,3351,4821,0.7,林英陸,民主進步黨
高雄市大社區神農里,-760,634,1394,3402,4814,0.7,葉秀英,無
高雄市大社區翠屏里,-432,173,605,1162,1587,0.7,匡淑芳,無
高雄市大社區觀音里,-911,668,1579,3784,5257,0.7,李世聰,無
高雄市小港區三苓里,-555,320,875,1927,2722,0.7,郭冠霖,無
高雄市小港區中厝里,-795,440,1235,2435,3579,0.7,方蒼賢,無
高雄市小港區二苓里,-661,388,1049,2449,3565,0.7,馮見仁,無
高雄市小港區六苓里,-731,191,922,1053,1401,0.8,陳美秀,無
高雄市小港區合作里,-744,325,1069,1970,2704,0.7,蘇麗美,民主進步黨
高雄市小港區坪頂里,-1596,763,2359,4116,6113,0.7,梁憲宗,無
高雄市小港區大坪里,-835,378,1213,2039,2951,0.7,梁正義,無
高雄市小港區大苓里,-616,294,910,1756,2460,0.7,歐世緯,無
高雄市小港區孔宅里,-840,494,1334,2642,3742,0.7,劉坤山,無
高雄市小港區宏亮里,-605,388,993,2171,3120,0.7,宋震寶,無
高雄市小港區小港里,-744,148,892,881,1274,0.7,洪世春,無
高雄市小港區山明里,-1920,1509,3429,7986,11435,0.7,陳阿子,無
高雄市小港區山東里,-275,360,635,2123,3074,0.7,黃聖凱,無
高雄市小港區店鎮里,-1385,616,2001,3817,5536,0.7,楊文良,無
高雄市小港區廈莊里,-199,622,821,2965,4255,0.7,李茂群,無
高雄市小港區松山里,-863,395,1258,2364,3196,0.7,王美華,無
高雄市小港區松金里,-899,262,1161,1400,2009,0.7,沈添福,無
高雄市小港區桂林里,-1374,1034,2408,5367,7558,0.7,侯原庭,無
高雄市小港區正苓里,-1084,463,1547,2650,3859,0.7,吳惠加,無
高雄市小港區泰山里,-695,393,1088,2420,3370,0.7,吳莧山,無
高雄市小港區港南里,-388,398,786,2012,3219,0.6,郭鶯鶯,民主進步黨
高雄市小港區港口里,-527,356,883,2209,3062,0.7,劉峰吉,無
高雄市小港區港后里,-899,310,1209,1861,2527,0.7,柯文世,民主進步黨
高雄市小港區港墘里,-471,216,687,1191,1675,0.7,吳文德,無
高雄市小港區港明里,-950,355,1305,2026,2990,0.7,李文正,無
高雄市小港區港正里,-902,312,1214,1771,2464,0.7,方林秀娥,無
高雄市小港區港興里,-752,293,1045,1684,2309,0.7,歐慧玲,民主進步黨
高雄市小港區濟南里,-736,478,1214,2964,4162,0.7,薛審,無
高雄市小港區青島里,-1086,139,1225,999,1378,0.7,戴又媛,中國國民黨
高雄市小港區順苓里,-593,568,1161,2956,4328,0.7,呂在和,無
高雄市小港區高松里,-1148,550,1698,3015,4391,0.7,梁志安,無
高雄市小港區鳳宮里,-792,358,1150,1800,2655,0.7,曾清全,無
高雄市小港區鳳林里,-690,302,992,2166,3124,0.7,張校銘,無
高雄市小港區鳳森里,-497,245,742,1604,2323,0.7,陳信雄,無
高雄市小港區鳳源里,-1324,302,1626,1729,2633,0.7,張宇讚,無
高雄市小港區鳳興里,-937,311,1248,1771,2600,0.7,洪富賢,無
高雄市小港區鳳鳴里,-965,349,1314,2133,3185,0.7,李月雲,無
高雄市小港區龍鳳里,-842,333,1175,2120,3156,0.7,黃文裕,無
高雄市岡山區三和里,-307,88,395,614,838,0.7,陳泰龍,無
高雄市岡山區仁壽里,-892,365,1257,2333,3182,0.7,劉永裕,無
高雄市岡山區仁義里,-865,178,1043,1375,1772,0.8,顏茂吉,無
高雄市岡山區信義里,-275,251,526,1122,1584,0.7,石秀霞,無
高雄市岡山區前峰里,-1052,369,1421,1940,2733,0.7,蔡佩玲,無
高雄市岡山區劉厝里,-366,163,529,1040,1362,0.8,劉慶煌,民主進步黨
高雄市岡山區協和里,-1286,464,1750,2511,3421,0.7,呂煌龍,無
高雄市岡山區協榮里,-346,256,602,1470,2022,0.7,王信惟,無
高雄市岡山區台上里,-1765,816,2581,4152,5779,0.7,李金本,無
高雄市岡山區和平里,-76,77,153,336,424,0.8,葉春蘭,無
高雄市岡山區嘉峰里,-454,201,655,1231,1694,0.7,高昭南,無
高雄市岡山區嘉興里,-633,368,1001,2363,3202,0.7,蔡宜眞,無
高雄市岡山區壽天里,-1128,407,1535,2293,3089,0.7,莊証州,無
高雄市岡山區壽峰里,-840,296,1136,1548,2145,0.7,李美麗,無
高雄市岡山區大莊里,-254,99,353,691,953,0.7,佘能文,無
高雄市岡山區大遼里,-447,166,613,1017,1353,0.8,蔡錫琛,無
高雄市岡山區岡山里,-881,535,1416,2805,4259,0.7,劉天賦,無
高雄市岡山區平安里,-191,162,353,1097,1488,0.7,劉登榮,無
高雄市岡山區後協里,-941,635,1576,3379,4689,0.7,李再富,無
高雄市岡山區後紅里,-695,579,1274,2943,4080,0.7,韓嘉嘉,無
高雄市岡山區忠孝里,-458,300,758,1965,2728,0.7,蔡秀惠,中國國民黨
高雄市岡山區本洲里,-314,206,520,1148,1609,0.7,施清德,無
高雄市岡山區潭底里,-372,71,443,562,760,0.7,陳勝傑,無
高雄市岡山區灣裡里,-668,226,894,1319,1798,0.7,林仁傑,無
高雄市岡山區為隨里,-112,181,293,975,1283,0.8,蔡正旭,無
高雄市岡山區白米里,-247,281,528,1489,2004,0.7,曾詠妮,無
高雄市岡山區石潭里,-805,208,1013,1392,1789,0.8,廖壹正,無
高雄市岡山區碧紅里,-317,503,820,2677,3735,0.7,李有財,無
高雄市岡山區福興里,-373,139,512,801,1029,0.8,何進柱,無
高雄市岡山區程香里,-356,529,885,2902,3939,0.7,劉承泰,無
高雄市岡山區竹圍里,-928,1015,1943,4846,6685,0.7,郭淑鈴,無
高雄市岡山區維仁里,-256,47,303,338,463,0.7,戴清福,無
高雄市岡山區華崗里,-592,175,767,1166,1492,0.8,杜光達,無
高雄市左營區中北里,-312,43,355,422,569,0.7,謝瑞真,無
高雄市左營區中南里,-214,35,249,335,486,0.7,蔣金守,無
高雄市左營區光輝里,-456,278,734,1719,2402,0.7,傅琪隆,中國國民黨
高雄市左營區合群里,-751,251,1002,1812,2459,0.7,倪同慧,中國國民黨
高雄市左營區城南里,-197,40,237,325,469,0.7,謝金得,無
高雄市左營區埤北里,-212,105,317,811,1183,0.7,李復慶,無
高雄市左營區埤東里,-314,71,385,633,874,0.7,鄒秀華,中國國民黨
高雄市左營區埤西里,-321,72,393,589,829,0.7,余清榮,無
高雄市左營區尾北里,-866,371,1237,2215,3079,0.7,柯錦德,中國國民黨
高雄市左營區尾南里,-302,66,368,481,681,0.7,余建明,無
高雄市左營區尾西里,-382,98,480,712,944,0.8,郭錦彬,無
高雄市左營區屏山里,-363,118,481,1011,1500,0.7,吳榮秀,中國國民黨
高雄市左營區崇實里,-778,491,1269,2334,3175,0.7,吳武雄,無
高雄市左營區廍北里,-107,44,151,309,407,0.8,薛朝文,無
高雄市左營區廍南里,-231,45,276,404,562,0.7,陳美惠,無
高雄市左營區廟北里,-243,66,309,583,811,0.7,蘇進雄,無
高雄市左營區廟東里,-363,53,416,580,791,0.7,謝惠娟,無
高雄市左營區新上里,-4307,3310,7617,18268,25075,0.7,王櫻樺,中國國民黨
高雄市左營區新下里,-3752,1921,5673,10141,13984,0.7,黃慶德,中國國民黨
高雄市左營區新中里,-1830,428,2258,2584,3557,0.7,黃昱誌,無
高雄市左營區新光里,-2699,1809,4508,9843,13612,0.7,黃麗純,中國國民黨
高雄市左營區明建里,-143,156,299,626,841,0.7,顏靜玉,無
高雄市左營區果峰里,-560,125,685,1001,1444,0.7,曾瑞水,中國國民黨
高雄市左營區果惠里,-501,129,630,986,1374,0.7,鄭夙雅,無
高雄市左營區果貿里,-677,265,942,1835,2588,0.7,韓得平,中國國民黨
高雄市左營區永清里,-57,171,228,550,857,0.6,郭鎮國,中國國民黨
高雄市左營區海勝里,-2122,519,2641,3865,5326,0.7,梁西榮,中國國民黨
高雄市左營區祥和里,-155,12,167,63,92,0.7,劉德文,中國國民黨
高雄市左營區福山里,-1657,5276,6933,24228,34263,0.7,葉德龍,中國國民黨
高雄市左營區聖南里,-261,53,314,365,507,0.7,陳勇利,無
高雄市左營區聖后里,-273,73,346,541,708,0.8,裴天成,無
高雄市左營區聖西里,-144,3,147,17,26,0.7,黃山本,無
高雄市左營區自助里,151,414,263,1362,1952,0.7,劉淯騰,民主進步黨
高雄市左營區莒光里,-316,149,465,1132,1712,0.7,柯麗枝,無
高雄市左營區菜公里,-3836,4098,7934,20751,28791,0.7,王振華,中國國民黨
高雄市左營區路東里,-293,60,353,506,672,0.8,黃秀綢,無
高雄市左營區進學里,-315,132,447,1081,2563,0.4,曹順雄,無
高雄市左營區頂北里,-166,48,214,394,524,0.8,詹正國,無
高雄市左營區頂西里,-179,78,257,649,866,0.7,方秀娟,民主進步黨
高雄市彌陀區光和里,-624,125,749,882,1206,0.7,林清火,無
高雄市彌陀區南寮里,-561,226,787,1441,2032,0.7,吳宏桂,無
高雄市彌陀區彌仁里,-205,35,240,350,503,0.7,梁天賞,無
高雄市彌陀區彌壽里,-367,79,446,576,749,0.8,吳義雄,無
高雄市彌陀區彌陀里,-431,212,643,1236,1666,0.7,林煌陸,無
高雄市彌陀區彌靖里,-443,178,621,1281,1774,0.7,吳志強,無
高雄市彌陀區文安里,-688,157,845,1119,1615,0.7,李泰山,無
高雄市彌陀區海尾里,-257,79,336,558,799,0.7,蘇政峯,無
高雄市彌陀區漯底里,-549,124,673,812,1093,0.7,孫萬賜,無
高雄市彌陀區舊港里,-454,174,628,1114,1501,0.7,李明山,無
高雄市彌陀區過港里,-428,105,533,619,883,0.7,張金長,無
高雄市彌陀區鹽埕里,-417,240,657,1451,1950,0.7,李允條,無
高雄市新興區中東里,-770,254,1024,1679,2658,0.6,林明雄,無
高雄市新興區仁聲里,-310,117,427,674,1004,0.7,蕭育霞,無
高雄市新興區光耀里,-415,259,674,1536,2122,0.7,吳秀鈴,民主進步黨
高雄市新興區南港里,-794,179,973,1405,1841,0.8,陳福明,民主進步黨
高雄市新興區大明里,-391,92,483,739,1008,0.7,徐慶宗,民主進步黨
高雄市新興區建興里,-275,106,381,608,899,0.7,薛富升,民主進步黨
高雄市新興區建華里,-299,94,393,594,833,0.7,吳文欽,無
高雄市新興區德政里,-278,74,352,458,613,0.7,謝國男,無
高雄市新興區德望里,-622,205,827,1276,1782,0.7,林郭麗玉,無
高雄市新興區德生里,-866,361,1227,2006,2758,0.7,吳三雄,民主進步黨
高雄市新興區愛平里,-308,133,441,690,943,0.7,高文龍,無
高雄市新興區成功里,-315,167,482,971,1319,0.7,童健良,中國國民黨
高雄市新興區振成里,-206,99,305,697,995,0.7,陳敏夫,無
高雄市新興區振華里,-311,103,414,726,1006,0.7,吳劍生,中國國民黨
高雄市新興區文昌里,-333,361,694,2085,2838,0.7,劉育洋,中國國民黨
高雄市新興區新江里,-403,112,515,708,1040,0.7,王金龍,無
高雄市新興區明莊里,-266,66,332,458,671,0.7,莊其章,無
高雄市新興區東坡里,-369,106,475,838,1138,0.7,楊福順,民主進步黨
高雄市新興區榮治里,-259,78,337,498,678,0.7,許淑芬,無
高雄市新興區正氣里,-520,139,659,943,1286,0.7,沈玉玲,無
高雄市新興區永寧里,-288,170,458,979,1372,0.7,施澤民,民主進步黨
高雄市新興區浩然里,-590,194,784,1230,1718,0.7,張榮源,中國國民黨
高雄市新興區漢民里,-166,82,248,521,723,0.7,李賢宗,無
高雄市新興區玉衡里,-257,63,320,478,666,0.7,蔡瑞彬,無
高雄市新興區秋山里,-341,102,443,662,989,0.7,許吳瑞珍,無
高雄市新興區興昌里,-644,108,752,637,868,0.7,黃少嫻,無
高雄市新興區華聲里,-314,97,411,640,892,0.7,林禮志,無
高雄市新興區蕉園里,-162,84,246,526,702,0.7,鄭凱隆,無
高雄市新興區長驛里,-284,97,381,617,904,0.7,葉智陽,無
高雄市新興區開平里,-1098,358,1456,2412,3211,0.8,陳朝居,無
高雄市新興區順昌里,-389,270,659,1559,2111,0.7,林朱堂,無
高雄市新興區黎明里,-273,71,344,572,806,0.7,許耀科,民主進步黨
高雄市旗山區三協里,-641,269,910,1510,2158,0.7,劉文寶,無
高雄市旗山區上洲里,-400,113,513,756,1109,0.7,柯瑞斌,無
高雄市旗山區中寮里,-97,11,108,124,176,0.7,洪萬祥,無
高雄市旗山區中正里,-384,131,515,889,1380,0.6,郭舜明,無
高雄市旗山區中洲里,-360,13,373,105,154,0.7,羅昱晴,無
高雄市旗山區南勝里,-622,151,773,1363,1997,0.7,廖宗吉,無
高雄市旗山區南洲里,-367,118,485,939,1363,0.7,黃吉祥,無
高雄市旗山區圓富里,-459,184,643,1130,1735,0.7,歐忠更,無
高雄市旗山區大山里,-283,129,412,922,1341,0.7,柯旗旺,無
高雄市旗山區大德里,-596,265,861,1544,2205,0.7,曾慶義,無
高雄市旗山區大林里,-340,100,440,808,1271,0.6,莊柏松,無
高雄市旗山區太平里,-523,223,746,1513,2132,0.7,鄭明成,無
高雄市旗山區廣福里,-115,60,175,401,597,0.7,陳俊吉,無
高雄市旗山區新光里,-341,63,404,526,731,0.7,陳峯翔,無
高雄市旗山區東平里,-609,186,795,1337,1857,0.7,石正忠,無
高雄市旗山區東昌里,-417,97,514,662,960,0.7,邱清郎,無
高雄市旗山區永和里,-455,341,796,2083,3090,0.7,周銹玉,無
高雄市旗山區湄洲里,-448,165,613,986,1486,0.7,陳聖允,民主進步黨
高雄市旗山區瑞吉里,-556,196,752,1310,1879,0.7,游俊樺,無
高雄市旗山區竹峰里,-365,168,533,1024,1452,0.7,郭信東,無
高雄市旗山區鯤洲里,-262,65,327,625,852,0.7,柯文化,民主進步黨
高雄市旗津區上竹里,-557,278,835,1810,2702,0.7,陳仲智,無
高雄市旗津區中洲里,-533,157,690,1228,1812,0.7,郭美伶,無
高雄市旗津區中興里,-789,259,1048,1736,2480,0.7,郭茂盛,無
高雄市旗津區中華里,-372,144,516,1064,1516,0.7,徐漢仁,無
高雄市旗津區北汕里,-582,273,855,1672,2596,0.6,林秀英,無
高雄市旗津區南汕里,-545,203,748,1325,2060,0.6,蔡明議,無
高雄市旗津區安順里,-191,93,284,604,920,0.7,莊武益,無
高雄市旗津區實踐里,-182,176,358,944,1481,0.6,楊台生,無
高雄市旗津區復興里,-1182,130,1312,931,1429,0.7,張順皇,無
高雄市旗津區慈愛里,-750,207,957,1401,2222,0.6,夏啓峯,無
高雄市旗津區振興里,-604,158,762,1068,1547,0.7,黃見益,無
高雄市旗津區旗下里,-291,124,415,824,1206,0.7,杜勝輝,無
高雄市旗津區永安里,-334,112,446,724,1083,0.7,黃修和,無
高雄市杉林區上平里,-380,98,478,879,1467,0.6,張福松,無
高雄市杉林區大愛里,-405,107,512,803,1428,0.6,賴東山,無
高雄市杉林區新庄里,-482,96,578,862,1403,0.6,陳勤招,無
高雄市杉林區月眉里,-461,156,617,1212,2037,0.6,官梅英,無
高雄市杉林區月美里,-360,83,443,751,1171,0.6,劉曉君,無
高雄市杉林區木梓里,-300,33,333,368,640,0.6,林同德,無
高雄市杉林區杉林里,-262,35,297,319,555,0.6,陳明昌,無
高雄市杉林區集來里,-323,70,393,676,1178,0.6,楊正雄,無
高雄市林園區中厝里,-683,301,984,1955,2888,0.7,劉誌華,中國國民黨
高雄市林園區中汕里,-453,183,636,1399,2119,0.7,黃國發,無
高雄市林園區中芸里,-433,162,595,1196,1686,0.7,謝樹來,無
高雄市林園區中門里,-943,270,1213,1660,2445,0.7,蘇信成,無
高雄市林園區五福里,-911,306,1217,1602,2524,0.6,洪月珍,無
高雄市林園區仁愛里,-1084,313,1397,2091,2874,0.7,呂繼承,無
高雄市林園區北汕里,-410,148,558,969,1505,0.6,謝宿惠,無
高雄市林園區廣應里,-1152,383,1535,2364,3357,0.7,陳玫玲,無
高雄市林園區文賢里,-988,305,1293,1685,2345,0.7,黃三源,無
高雄市林園區東林里,-492,312,804,1916,2849,0.7,盧盈叡,無
高雄市林園區東汕里,-323,110,433,762,1175,0.6,王福成,中國國民黨
高雄市林園區林內里,-515,222,737,1307,1915,0.7,黃清景,無
高雄市林園區林園里,-902,327,1229,2070,2923,0.7,黃盟松,無
高雄市林園區林家里,-341,191,532,1231,1780,0.7,林明田,無
高雄市林園區港嘴里,-897,159,1056,1139,1646,0.7,蔡明興,無
高雄市林園區港埔里,-540,210,750,1222,1722,0.7,吳石南,無
高雄市林園區溪州里,-1457,522,1979,2774,4110,0.7,黃國輝,無
高雄市林園區潭頭里,-1195,290,1485,1777,2616,0.7,劉建德,無
高雄市林園區王公里,-1413,455,1868,2734,3972,0.7,洪進財,無
高雄市林園區西汕里,-328,32,360,227,351,0.6,邱鐘城,無
高雄市林園區西溪里,-1412,339,1751,2256,3304,0.7,李文通,無
高雄市林園區頂厝里,-1689,528,2217,3080,4544,0.7,陳碧對,無
高雄市林園區鳳芸里,-481,157,638,1237,1695,0.7,王泰山,無
高雄市林園區龔厝里,-988,146,1134,1007,1397,0.7,龔芳生,無
高雄市桃源區勤和里,-67,37,104,258,455,0.6,曾江清水,無
高雄市桃源區寶山里,-132,59,191,453,732,0.6,陳燕霜,無
高雄市桃源區建山里,-208,35,243,193,290,0.7,陳建億,無
高雄市桃源區復興里,-66,27,93,171,281,0.6,江孫財,無
高雄市桃源區拉芙蘭里,-80,31,111,267,474,0.6,謝貴奇,無
高雄市桃源區桃源里,-521,16,537,129,246,0.5,高慕源,無
高雄市桃源區梅山里,-116,18,134,182,263,0.7,顏忠義,無
高雄市桃源區高中里,-274,47,321,377,648,0.6,胡益明,無
高雄市梓官區中崙里,-379,121,500,817,1078,0.8,歐樹發,無
高雄市梓官區信蚵里,-461,273,734,1719,2462,0.7,曾盈豐,無
高雄市梓官區典寶里,-1126,330,1456,2104,2913,0.7,洪文清,無
高雄市梓官區同安里,-264,197,461,1136,1572,0.7,蔣榮三,無
高雄市梓官區大舍里,-952,347,1299,2121,2972,0.7,歐淼宗,無
高雄市梓官區智蚵里,-629,362,991,2291,3246,0.7,鄭柏政,無
高雄市梓官區梓信里,-507,237,744,1514,2034,0.7,蘇上火,無
高雄市梓官區梓和里,-1118,217,1335,1629,2130,0.8,姜志豪,無
高雄市梓官區梓平里,-276,172,448,1084,1406,0.8,黃常吉,無
高雄市梓官區梓義里,-356,237,593,1453,2086,0.7,余煊昱,無
高雄市梓官區禮蚵里,-523,150,673,1051,1492,0.7,蔡添寳,無
高雄市梓官區茄苳里,-629,253,882,1525,2165,0.7,劉和村,無
高雄市梓官區赤崁里,-704,173,877,1251,1777,0.7,蔡良鑑,中國國民黨
高雄市梓官區赤東里,-555,224,779,1565,2152,0.7,郭錦成,無
高雄市梓官區赤西里,-357,71,428,532,760,0.7,劉英凱,無
高雄市楠梓區中和里,-441,918,1359,3585,5116,0.7,李東宇,無
高雄市楠梓區中興里,-523,365,888,1680,2329,0.7,黃朝吉,無
高雄市楠梓區中陽里,-619,437,1056,2354,3420,0.7,李添發,無
高雄市楠梓區久昌里,-202,370,572,1939,2801,0.7,辜清桐,無
高雄市楠梓區五常里,-1597,886,2483,4267,6378,0.7,曾榮璋,無
高雄市楠梓區享平里,-900,408,1308,2201,3253,0.7,陳顯能,無
高雄市楠梓區仁昌里,-1423,757,2180,3500,5030,0.7,王永坤,中國國民黨
高雄市楠梓區加昌里,-1886,1050,2936,5592,7966,0.7,劉秀英,無
高雄市楠梓區和昌里,-404,193,597,1434,1986,0.7,周海玲,無
高雄市楠梓區國昌里,-727,289,1016,1636,2308,0.7,陳健成,無
高雄市楠梓區大昌里,-567,239,806,1434,2059,0.7,戴嘉育,中國國民黨
高雄市楠梓區宏南里,-78,86,164,577,788,0.7,張夢麒,無
高雄市楠梓區宏昌里,-664,398,1062,2278,3183,0.7,劉秀桃,無
高雄市楠梓區宏榮里,-683,333,1016,1832,2500,0.7,陳宏榮,中國國民黨
高雄市楠梓區宏毅里,-920,252,1172,1560,2088,0.7,馮靖絨,無
高雄市楠梓區廣昌里,-590,292,882,2079,2882,0.7,蔡文東,無
高雄市楠梓區建昌里,-812,287,1099,1763,2510,0.7,曾讚義,中國國民黨
高雄市楠梓區惠楠里,-598,285,883,1479,2218,0.7,張珮榕,無
高雄市楠梓區惠民里,-371,660,1031,3233,4594,0.7,張淑分,無
高雄市楠梓區惠豐里,-625,656,1281,3331,4727,0.7,張翼麟,無
高雄市楠梓區慶昌里,-922,326,1248,2263,3064,0.7,陳玉梅,中國國民黨
高雄市楠梓區東寧里,-887,800,1687,3384,4734,0.7,蘇吳錦秀,無
高雄市楠梓區泰昌里,-312,143,455,995,1424,0.7,鄭嘉平,無
高雄市楠梓區清豐里,-3254,3183,6437,15667,21789,0.7,戴佑東,無
高雄市楠梓區玉屏里,-467,228,695,1584,2079,0.8,洪千雅,無
高雄市楠梓區瑞屏里,-1370,401,1771,2406,3411,0.7,郭進和,無
高雄市楠梓區盛昌里,-504,693,1197,3944,5386,0.7,李再生,中國國民黨
高雄市楠梓區福昌里,-931,231,1162,1583,2088,0.8,張育綺,無
高雄市楠梓區秀昌里,-352,230,582,1510,2055,0.7,張明全,中國國民黨
高雄市楠梓區稔田里,-190,176,366,1215,1616,0.8,陳瑞輅,無
高雄市楠梓區翠屏里,-2078,2239,4317,10740,15653,0.7,吳永晨,無
高雄市楠梓區興昌里,-576,552,1128,3096,4291,0.7,藍李九寳,中國國民黨
高雄市楠梓區藍田里,-847,1605,2452,6127,8296,0.7,謝坤易,民主進步黨
高雄市楠梓區裕昌里,-571,658,1229,3348,4687,0.7,郭明勲,無
高雄市楠梓區金田里,-1305,606,1911,3021,4179,0.7,邱世宗,無
高雄市楠梓區錦屏里,-730,200,930,1492,1979,0.8,蔡甲庚,無
高雄市楠梓區隆昌里,-355,300,655,1679,2337,0.7,徐愛琳,無
高雄市橋頭區三德里,-223,70,293,585,756,0.8,劉崇凱,無
高雄市橋頭區中崎里,-297,70,367,469,627,0.7,蘇招治,無
高雄市橋頭區仕和里,-1413,453,1866,2735,3546,0.8,朱高成,無
高雄市橋頭區仕豐里,-572,361,933,1986,2583,0.8,周才淵,民主進步黨
高雄市橋頭區仕隆里,-565,228,793,1625,2155,0.8,馬兆賢,無
高雄市橋頭區德松里,-350,199,549,1118,1444,0.8,何東喜,民主進步黨
高雄市橋頭區新莊里,-9,1187,1196,4315,5880,0.7,朱正清,無
高雄市橋頭區東林里,-841,261,1102,1634,2172,0.8,陸見青,無
高雄市橋頭區橋南里,-422,168,590,1133,1474,0.8,蘇道明,無
高雄市橋頭區橋頭里,-480,208,688,1151,1532,0.8,余美蓮,無
高雄市橋頭區甲北里,-408,340,748,1650,2346,0.7,李林足素,無
高雄市橋頭區甲南里,-1049,271,1320,1748,2354,0.7,方明賢,無
高雄市橋頭區白樹里,-545,412,957,2341,3173,0.7,戴寬和,無
高雄市橋頭區筆秀里,-376,159,535,1102,1452,0.8,詹嘉郁,民主進步黨
高雄市橋頭區芋寮里,-199,132,331,869,1137,0.8,傅壽勝,無
高雄市橋頭區西林里,-758,128,886,1009,1306,0.8,吳建豐,無
高雄市橋頭區頂鹽里,-375,218,593,1368,1851,0.7,顏家進,無
高雄市永安區保寧里,-486,373,859,1822,2548,0.7,陳文印,無
高雄市永安區新港里,-458,308,766,1886,2708,0.7,何應成,無
高雄市永安區永安里,-465,136,601,839,1199,0.7,郭憲明,無
高雄市永安區永華里,-506,205,711,1306,1813,0.7,林明春,無
高雄市永安區維新里,-782,458,1240,2350,3310,0.7,蔣福山,無
高雄市永安區鹽田里,-161,33,194,278,401,0.7,柯男烈,無
高雄市湖內區中賢里,-470,308,778,1866,2723,0.7,王阮寶雲,無
高雄市湖內區公舘里,-409,327,736,1618,2206,0.7,林蘇麗雲,無
高雄市湖內區劉家里,-189,135,324,1017,1449,0.7,劉宏添,無
高雄市湖內區大湖里,-672,447,1119,2348,3251,0.7,洪添謀,無
高雄市湖內區太爺里,-235,82,317,561,746,0.8,蘇宗傑,無
高雄市湖內區忠興里,-232,125,357,860,1239,0.7,邱韋能,無
高雄市湖內區文賢里,-322,71,393,448,602,0.7,林金坤,無
高雄市湖內區海埔里,-427,210,637,1195,1694,0.7,杜丙戍,無
高雄市湖內區海山里,-511,47,558,367,519,0.7,劉寶霞,無
高雄市湖內區湖內里,-722,530,1252,2662,3735,0.7,魏漢仁,無
高雄市湖內區湖東里,-670,347,1017,1813,2683,0.7,黃太平,無
高雄市湖內區田尾里,-347,167,514,1034,1411,0.7,謝秋影,無
高雄市湖內區葉厝里,-848,320,1168,1872,2608,0.7,葉進昌,無
高雄市湖內區逸賢里,-440,71,511,384,553,0.7,林秀卿,無
高雄市燕巢區南燕里,-645,468,1113,2616,3841,0.7,龔榮源,無
高雄市燕巢區安招里,-542,361,903,2335,3234,0.7,李金福,無
高雄市燕巢區尖山里,-455,93,548,767,1105,0.7,何旭信,無
高雄市燕巢區東燕里,-862,265,1127,1625,2252,0.7,吳振武,無
高雄市燕巢區橫山里,-472,185,657,1207,1782,0.7,陳隆盛,無
高雄市燕巢區深水里,-725,206,931,1548,2332,0.7,林明雄,無
高雄市燕巢區瓊林里,-876,263,1139,1488,2022,0.7,張舜傑,無
高雄市燕巢區西燕里,-1127,431,1558,2299,3210,0.7,李秀英,無
高雄市燕巢區角宿里,-793,352,1145,1989,2657,0.7,莊璨隆,無
高雄市燕巢區金山里,-123,41,164,299,425,0.7,林順輔,無
高雄市燕巢區鳳雄里,-919,247,1166,1639,2367,0.7,陳明發,無
高雄市田寮區七星里,-274,38,312,395,585,0.7,呂革明,無
高雄市田寮區三和里,-158,24,182,188,318,0.6,林正春,無
高雄市田寮區南安里,-288,71,359,615,943,0.7,黃朝添,無
高雄市田寮區古亭里,-184,23,207,305,454,0.7,許英豪,無
高雄市田寮區大同里,-159,24,183,217,351,0.6,王榮華,無
高雄市田寮區崇德里,-384,105,489,640,885,0.7,陳金城,無
高雄市田寮區新興里,-464,91,555,796,1120,0.7,何百農,無
高雄市田寮區田寮里,-179,11,190,223,343,0.7,連于萱,無
高雄市田寮區西德里,-355,57,412,485,729,0.7,黃萬春,無
高雄市田寮區鹿埔里,-165,17,182,242,342,0.7,楊美芬,無
高雄市甲仙區和安里,-292,43,335,399,639,0.6,李新福,中國國民黨
高雄市甲仙區大田里,-437,109,546,842,1461,0.6,張琪,無
高雄市甲仙區寶隆里,-300,34,334,370,616,0.6,連英朱,無
高雄市甲仙區小林里,-173,36,209,281,488,0.6,潘世彬,無
高雄市甲仙區東安里,-123,48,171,225,420,0.5,游新儀,中國國民黨
高雄市甲仙區西安里,-436,67,503,570,826,0.7,范姮枝,中國國民黨
高雄市甲仙區關山里,-280,29,309,373,560,0.7,林欣郿,無
高雄市美濃區中圳里,-542,205,747,1374,2010,0.7,黃其添,無
高雄市美濃區中壇里,-470,146,616,933,1423,0.7,楊秋田,無
高雄市美濃區合和里,-389,171,560,1245,1928,0.6,林作松,無
高雄市美濃區吉和里,-358,144,502,912,1306,0.7,黃文梅,無
高雄市美濃區吉東里,-518,166,684,1130,1693,0.7,黃新華,無
高雄市美濃區吉洋里,-444,140,584,1154,1743,0.7,曾順昌,無
高雄市美濃區廣德里,-262,154,416,1151,1773,0.6,黃沛文,無
高雄市美濃區廣林里,-622,101,723,863,1365,0.6,傅兆鎮,無
高雄市美濃區德興里,-248,135,383,970,1392,0.7,黃建雄,無
高雄市美濃區東門里,-184,120,304,957,1489,0.6,羅文俊,無
高雄市美濃區泰安里,-253,192,445,1039,1515,0.7,邱國維,無
高雄市美濃區清水里,-412,145,557,1111,1623,0.7,張金發,無
高雄市美濃區瀰濃里,-250,202,452,1410,2180,0.6,林仁興,無
高雄市美濃區獅山里,-857,187,1044,1591,2363,0.7,鍾明福,無
高雄市美濃區祿興里,-576,307,883,1988,2962,0.7,劉昭宏,無
高雄市美濃區福安里,-360,207,567,1616,2459,0.7,古能魁,無
高雄市美濃區興隆里,-355,45,400,358,543,0.7,黃耀榮,無
高雄市美濃區龍山里,-993,160,1153,1326,2015,0.7,温源興,無
高雄市美濃區龍肚里,-403,90,493,893,1323,0.7,邱連發,無
高雄市苓雅區中正里,-904,347,1251,1975,2631,0.8,胡維成,中國國民黨
高雄市苓雅區五權里,-618,248,866,1651,2157,0.8,陳玉環,無
高雄市苓雅區五福里,-750,347,1097,2509,3470,0.7,邱瑞祥,民主進步黨
高雄市苓雅區人和里,-650,175,825,1152,1640,0.7,林志田,民主進步黨
高雄市苓雅區仁政里,-511,125,636,893,1203,0.7,黃裕庭,無
高雄市苓雅區光華里,-297,62,359,477,670,0.7,吳照鉠,民主進步黨
高雄市苓雅區凱旋里,-821,253,1074,1511,2044,0.7,錢雲徽,中國國民黨
高雄市苓雅區博仁里,-239,64,303,458,637,0.7,陳奇伯,中國國民黨
高雄市苓雅區同慶里,-586,269,855,1487,1980,0.8,高文明,無
高雄市苓雅區和煦里,-526,227,753,1373,1837,0.7,莊財通,無
高雄市苓雅區城北里,-193,192,385,1121,1545,0.7,李佳容,無
高雄市苓雅區城東里,-350,221,571,1258,1800,0.7,史妮可,無
高雄市苓雅區城西里,-248,2,250,13,19,0.7,朱育賢,無
高雄市苓雅區奏捷里,-469,183,652,1106,1472,0.8,林豐富,民主進步黨
高雄市苓雅區安祥里,-445,321,766,1988,2696,0.7,董輝章,中國國民黨
高雄市苓雅區尚義里,-536,167,703,1115,1507,0.7,曾蔡玉燕,中國國民黨
高雄市苓雅區廣澤里,-432,181,613,1222,1639,0.7,沈秀美,無
高雄市苓雅區建軍里,-507,141,648,805,1109,0.7,蘇昆明,民主進步黨
高雄市苓雅區意誠里,-968,388,1356,2356,3652,0.6,蕭長保,中國國民黨
高雄市苓雅區文昌里,-825,384,1209,2538,3512,0.7,林博文,民主進步黨
高雄市苓雅區日中里,-293,220,513,1487,2000,0.7,許愛珠,無
高雄市苓雅區普天里,-593,413,1006,2406,3243,0.7,李文豪,無
高雄市苓雅區普照里,-537,298,835,2141,2904,0.7,歐明興,中國國民黨
高雄市苓雅區晴朗里,-346,251,597,1372,2643,0.5,孫永吉,無
高雄市苓雅區朝陽里,-242,147,389,990,1359,0.7,丁文瑞,無
高雄市苓雅區林中里,-894,282,1176,1874,2641,0.7,杜佳福,無
高雄市苓雅區林南里,-885,273,1158,1932,2670,0.7,黃旭煌,無
高雄市苓雅區林圍里,-445,291,736,1642,2148,0.8,羅莉萍,中國國民黨
高雄市苓雅區林安里,-449,198,647,1086,1482,0.7,張列綱,無
高雄市苓雅區林富里,-813,295,1108,1650,2168,0.8,林進安,無
高雄市苓雅區林德里,-630,211,841,1225,1680,0.7,翁正財,無
高雄市苓雅區林榮里,-1170,485,1655,2626,3633,0.7,王文祿,無
高雄市苓雅區林泉里,-475,205,680,1312,1748,0.8,翁烔訓,中國國民黨
高雄市苓雅區林興里,-426,120,546,821,1180,0.7,黃培裕,民主進步黨
高雄市苓雅區林華里,-549,258,807,1852,2481,0.7,張家偉,民主進步黨
高雄市苓雅區林西里,-401,147,548,1038,1475,0.7,方琪麟,中國國民黨
高雄市苓雅區林貴里,-246,211,457,1280,1706,0.8,黃清溪,無
高雄市苓雅區林靖里,-329,173,502,1115,1502,0.7,蔡温怡,無
高雄市苓雅區正仁里,-370,321,691,1696,2342,0.7,黃敏捷,無
高雄市苓雅區正大里,-1186,595,1781,3394,4814,0.7,陳錦宏,無
高雄市苓雅區正心里,-791,394,1185,2460,3369,0.7,陳顏秋萍,中國國民黨
高雄市苓雅區正文里,-811,324,1135,1793,2395,0.7,莊文忠,無
高雄市苓雅區正義里,-833,266,1099,1700,2246,0.8,劉銀連,中國國民黨
高雄市苓雅區正言里,-765,223,988,1412,1938,0.7,古金川,無
高雄市苓雅區正道里,-1249,462,1711,2822,3965,0.7,楊舜堡,無
高雄市苓雅區民主里,-1227,493,1720,2940,4035,0.7,陳文程,無
高雄市苓雅區永康里,-375,252,627,1459,1999,0.7,蔡長志,無
高雄市苓雅區田西里,-396,163,559,934,1266,0.7,郭國民,中國國民黨
高雄市苓雅區福人里,-384,196,580,1333,1900,0.7,陳學偉,無
高雄市苓雅區福南里,-370,172,542,1193,1642,0.7,蘇文安,無
高雄市苓雅區福地里,-532,262,794,1725,2426,0.7,蔡添財,無
高雄市苓雅區福壽里,-505,154,659,1014,1374,0.7,郭寬洲,民主進步黨
高雄市苓雅區福居里,-630,245,875,1757,2477,0.7,吳明憲,民主進步黨
高雄市苓雅區福康里,-333,191,524,1246,1732,0.7,陳信吾,無
高雄市苓雅區福東里,-682,284,966,1741,2423,0.7,劉呂燕芬,無
高雄市苓雅區福海里,-354,125,479,733,1007,0.7,廖富男,中國國民黨
高雄市苓雅區福祥里,-411,168,579,896,1239,0.7,劉榮福,民主進步黨
高雄市苓雅區福西里,-683,185,868,1269,1776,0.7,黃正德,無
高雄市苓雅區福隆里,-900,309,1209,1913,2672,0.7,郭彌堅,民主進步黨
高雄市苓雅區美田里,-391,120,511,754,1073,0.7,吳金對,無
高雄市苓雅區苓中里,-410,193,603,1157,1548,0.7,吳敏寬,無
高雄市苓雅區苓昇里,-228,120,348,792,1123,0.7,陳文喜,無
高雄市苓雅區苓東里,-193,136,329,952,1368,0.7,楊玉鳳,無
高雄市苓雅區苓洲里,-421,169,590,1064,1532,0.7,吳弘宜,中國國民黨
高雄市苓雅區苓雅里,-299,151,450,977,1382,0.7,郭釗琦,無
高雄市苓雅區英明里,-542,190,732,1252,1718,0.7,黃秀靜,無
高雄市苓雅區華堂里,-943,299,1242,2021,2858,0.7,曾興德,無
高雄市苓雅區衛武里,-680,199,879,1324,1826,0.7,邱秀迷,無
高雄市苓雅區鼓中里,-400,82,482,633,880,0.7,郭明鴻,無
高雄市茂林區多納里,-220,47,267,351,490,0.7,羅耀明,中國國民黨
高雄市茂林區茂林里,-236,88,324,532,711,0.7,"田振弘 Kukui‧Pakadavy",中國國民黨
高雄市茂林區萬山里,-298,24,322,277,361,0.8,蔡正男,無
高雄市茄萣區保定里,-1047,264,1311,1564,2235,0.7,郭淑芬,無
高雄市茄萣區光定里,-185,90,275,575,871,0.7,林高華,無
高雄市茄萣區吉定里,-374,129,503,794,1088,0.7,薛賢成,無
高雄市茄萣區和協里,-404,122,526,836,1249,0.7,吳進發,無
高雄市茄萣區嘉安里,-719,107,826,674,961,0.7,林陳麗雯,無
高雄市茄萣區嘉定里,-248,130,378,913,1329,0.7,歐清信,無
高雄市茄萣區嘉樂里,-466,223,689,1501,2174,0.7,郭松南,無
高雄市茄萣區嘉泰里,-278,115,393,826,1211,0.7,鄭君男,無
高雄市茄萣區嘉福里,-229,125,354,755,1142,0.7,吳財榮,無
高雄市茄萣區嘉賜里,-1239,449,1688,2572,3697,0.7,葉宏信,民主進步黨
高雄市茄萣區大定里,-260,145,405,915,1325,0.7,薛金成,無
高雄市茄萣區崎漏里,-1249,530,1779,3124,4709,0.7,邱美麗,無
高雄市茄萣區白雲里,-427,168,595,933,1242,0.8,郭麗華,無
高雄市茄萣區福德里,-230,142,372,996,1346,0.7,陳茂生,無
高雄市茄萣區萬福里,-379,86,465,560,825,0.7,蘇永南,無
高雄市路竹區三爺里,-304,134,438,800,1090,0.7,康庭琰,無
高雄市路竹區下坑里,-696,299,995,1546,2101,0.7,王金水,無
高雄市路竹區北嶺里,-321,161,482,1096,1470,0.7,黃松德,無
高雄市路竹區後鄉里,-328,244,572,1219,1618,0.8,金宜頵,無
高雄市路竹區文北里,-507,429,936,2088,2855,0.7,陳慶宗,無
高雄市路竹區文南里,-627,244,871,1242,1624,0.8,許明嘉,無
高雄市路竹區新達里,-180,203,383,1100,1495,0.7,杜明昌,無
高雄市路竹區甲北里,-345,377,722,1890,2650,0.7,王文梁,無
高雄市路竹區甲南里,-731,325,1056,1834,2562,0.7,黃吉松,無
高雄市路竹區社中里,-267,97,364,551,801,0.7,魏林寶菊,無
高雄市路竹區社南里,-644,622,1266,3286,4456,0.7,石永昌,中國國民黨
高雄市路竹區社東里,-439,285,724,1624,2162,0.8,蘇鑫,無
高雄市路竹區社西里,-844,227,1071,1166,1614,0.7,馬旭來,無
高雄市路竹區竹南里,-511,303,814,1818,2542,0.7,高月英,無
高雄市路竹區竹園里,-545,291,836,1567,2226,0.7,辛瑞賢,無
高雄市路竹區竹東里,-877,482,1359,2551,3375,0.8,程啓龍,無
高雄市路竹區竹滬里,-979,362,1341,1685,2472,0.7,劉崑芳,無
高雄市路竹區竹西里,-621,264,885,1511,2061,0.7,黃李月施,無
高雄市路竹區頂寮里,-292,176,468,1019,1407,0.7,黃居賢,無
高雄市路竹區鴨寮里,-782,169,951,958,1281,0.7,蘇清吉,無
高雄市那瑪夏區南沙魯里,-181,25,206,336,466,0.7,劉陳玉梅,無
高雄市那瑪夏區瑪雅里,-274,56,330,422,623,0.7,許利滿,無
高雄市那瑪夏區達卡努瓦里,-893,91,984,728,1328,0.5,朱子亮,無
高雄市阿蓮區中路里,-637,183,820,1361,1894,0.7,林永信,無
高雄市阿蓮區南蓮里,-930,377,1307,2017,2859,0.7,林首相,無
高雄市阿蓮區和蓮里,-876,216,1092,1251,1722,0.7,陳秀裡,無
高雄市阿蓮區峯山里,-573,111,684,831,1167,0.7,鄭鴻哖,無
高雄市阿蓮區崗山里,-375,85,460,533,763,0.7,吳尚儒,無
高雄市阿蓮區復安里,-672,115,787,848,1196,0.7,何榮華,中國國民黨
高雄市阿蓮區清蓮里,-483,281,764,1746,2505,0.7,李丁美玲,無
高雄市阿蓮區港後里,-537,295,832,1804,2525,0.7,鄭文能,無
高雄市阿蓮區玉庫里,-441,133,574,968,1382,0.7,鄭明聰,無
高雄市阿蓮區石安里,-373,172,545,1141,1593,0.7,蔡寬意,無
高雄市阿蓮區阿蓮里,-1380,564,1944,3235,4661,0.7,黃靖娟,無
高雄市阿蓮區青旗里,-604,134,738,760,1120,0.7,陳文曉,無
高雄市鳥松區仁美里,-1413,754,2167,4785,6688,0.7,吳家儒,無
高雄市鳥松區坔埔里,-1146,431,1577,2650,3542,0.7,黃永順,民主進步黨
高雄市鳥松區夢裡里,-1615,669,2284,3955,5367,0.7,陳萬丁,無
高雄市鳥松區大竹里,-350,20,370,134,184,0.7,蔡榮瑞,無
高雄市鳥松區大華里,-1684,1267,2951,7610,10058,0.8,蔡美蘭,中國國民黨
高雄市鳥松區華美里,-757,448,1205,2824,3875,0.7,邱宏棋,無
高雄市鳥松區鳥松里,-2102,1155,3257,6551,9371,0.7,謝唐欽,無
高雄市鳳山區一甲里,-690,354,1044,2332,3334,0.7,蔡瑋誠,無
高雄市鳳山區三民里,-435,140,575,804,1076,0.7,黃榮貴,無
高雄市鳳山區中和里,-728,394,1122,2383,3193,0.7,張簡進興,無
高雄市鳳山區中崙里,-619,214,833,1142,1627,0.7,林齊諒,無
高雄市鳳山區中榮里,-1142,562,1704,3049,4387,0.7,劉秀美,無
高雄市鳳山區中正里,-1023,462,1485,2957,4057,0.7,鄒家駿,中國國民黨
高雄市鳳山區中民里,-1172,560,1732,3305,4684,0.7,黃金利,無
高雄市鳳山區二甲里,-838,600,1438,3475,4754,0.7,黃昭雄,無
高雄市鳳山區五福里,-768,236,1004,1437,1959,0.7,王劉煌,無
高雄市鳳山區保安里,-1337,992,2329,4952,6603,0.7,謝昆政,無
高雄市鳳山區光明里,-453,154,607,886,1262,0.7,王俊富,無
高雄市鳳山區北門里,-1252,436,1688,2702,3777,0.7,謝秀霞,民主進步黨
高雄市鳳山區協和里,-1158,384,1542,2197,2932,0.7,羅美滿,無
高雄市鳳山區南和里,-595,302,897,2009,2792,0.7,李錦珠,民主進步黨
高雄市鳳山區南成里,-2534,1355,3889,6851,9318,0.7,楊居財,無
高雄市鳳山區南興里,-344,100,444,633,846,0.7,廖春花,無
高雄市鳳山區和德里,-751,454,1205,2033,2762,0.7,吳金池,無
高雄市鳳山區和興里,-742,549,1291,3274,4356,0.8,林永森,無
高雄市鳳山區善美里,-381,720,1101,4030,5784,0.7,張育臺,民主進步黨
高雄市鳳山區國光里,-1326,252,1578,1677,2360,0.7,呂岳霖,無
高雄市鳳山區國富里,-598,352,950,2011,2702,0.7,陳振沛,無
高雄市鳳山區國泰里,-732,374,1106,2700,3801,0.7,黃昭清,無
高雄市鳳山區國隆里,-729,240,969,1786,2533,0.7,呂富貴,無
高雄市鳳山區埤頂里,-1990,696,2686,4114,5683,0.7,謝順和,無
高雄市鳳山區大德里,-969,508,1477,3255,4556,0.7,侯俊傑,無
高雄市鳳山區天興里,-647,398,1045,2571,3570,0.7,郭秉鑫,無
高雄市鳳山區富榮里,-514,228,742,1155,1592,0.7,郭登臨,無
高雄市鳳山區富甲里,-472,237,709,1462,2083,0.7,王筱銜,無
高雄市鳳山區忠孝里,-1591,603,2194,3872,5384,0.7,蔡美雪,無
高雄市鳳山區忠義里,-1260,615,1875,3201,4309,0.7,李朝清,無
高雄市鳳山區忠誠里,-946,476,1422,2470,3415,0.7,陳永壽,無
高雄市鳳山區成功里,-301,18,319,122,169,0.7,鄭美玉,無
高雄市鳳山區文山里,-2149,813,2962,4414,6076,0.7,黃惠玲,民主進步黨
高雄市鳳山區文德里,-2732,1195,3927,6424,8832,0.7,謝智華,無
高雄市鳳山區文福里,-2651,1405,4056,6808,9205,0.7,余世善,無
高雄市鳳山區文英里,-1150,484,1634,2542,3484,0.7,鄭鴻章,無
高雄市鳳山區文華里,-2709,1006,3715,5785,7903,0.7,張嘉玲,無
高雄市鳳山區文衡里,-518,573,1091,2867,3993,0.7,洪啟修,無
高雄市鳳山區新富里,-739,491,1230,3049,4198,0.7,李金福,無
高雄市鳳山區新強里,-1170,581,1751,3217,4293,0.7,李得勝,民主進步黨
高雄市鳳山區新樂里,-1318,461,1779,2318,3155,0.7,李滋宏,民主進步黨
高雄市鳳山區新武里,-275,386,661,2099,2790,0.8,黃龍秋,無
高雄市鳳山區新泰里,-638,594,1232,3033,4166,0.7,歐諺霖,無
高雄市鳳山區新甲里,-833,422,1255,2350,3224,0.7,柯寶凱,無
高雄市鳳山區新興里,-508,184,692,1166,3408,0.3,郭傅美金,無
高雄市鳳山區曹公里,-190,221,411,1360,1862,0.7,曾齡瑩,無
高雄市鳳山區東門里,-878,713,1591,3943,5641,0.7,劉晋祥,無
高雄市鳳山區正義里,-1598,588,2186,3588,4952,0.7,鄭洂汯,無
高雄市鳳山區武慶里,-284,349,633,1995,2724,0.7,林振隆,無
高雄市鳳山區武松里,-624,305,929,1779,2544,0.7,戴惠敏,無
高雄市鳳山區武漢里,-1612,487,2099,2778,3955,0.7,蘇弘展,民主進步黨
高雄市鳳山區海光里,-502,344,846,1980,2744,0.7,鍾翠民,無
高雄市鳳山區海洋里,-667,520,1187,2988,3985,0.7,蔡秀寶,無
高雄市鳳山區瑞竹里,-1458,572,2030,3648,5076,0.7,李美雲,中國國民黨
高雄市鳳山區瑞興里,-1409,693,2102,3589,4922,0.7,王玉蘭,中國國民黨
高雄市鳳山區生明里,-720,218,938,1423,1938,0.7,郭清竹,中國國民黨
高雄市鳳山區福祥里,-422,350,772,2209,3041,0.7,李安琪,無
高雄市鳳山區福興里,-1029,461,1490,3053,4397,0.7,鄭陳麗珠,無
高雄市鳳山區福誠里,-1267,727,1994,3816,5130,0.7,許德發,民主進步黨
高雄市鳳山區縣口里,-187,4,191,22,34,0.6,洪敏川,無
高雄市鳳山區縣衙里,-303,104,407,582,802,0.7,王鈴雅,中國國民黨
高雄市鳳山區老爺里,-1341,812,2153,4929,6880,0.7,李菁雅,無
高雄市鳳山區興中里,-310,137,447,668,864,0.8,林天財,中國國民黨
高雄市鳳山區興仁里,-1088,386,1474,2340,3177,0.7,林曾桂花,無
高雄市鳳山區誠信里,-852,154,1006,936,1325,0.7,蔡自謄,中國國民黨
高雄市鳳山區誠德里,-585,324,909,1788,2485,0.7,陳世寳,中國國民黨
高雄市鳳山區誠智里,-551,309,860,1784,2595,0.7,黃桂花,中國國民黨
高雄市鳳山區誠義里,-1323,549,1872,2847,3696,0.8,劉啓芳,中國國民黨
高雄市鳳山區過埤里,-1255,2148,3403,10083,14164,0.7,莫尚忠,無
高雄市鳳山區鎮北里,-2696,1651,4347,7339,10407,0.7,趙志成,無
高雄市鳳山區鎮南里,-1013,480,1493,2845,3936,0.7,楊三吉,民主進步黨
高雄市鳳山區鎮東里,-818,339,1157,1739,2443,0.7,張簡裕芳,無
高雄市鳳山區鎮西里,-535,594,1129,3397,4599,0.7,李陳金治,無
高雄市鳳山區鳳崗里,-420,128,548,848,1150,0.7,董錦慧,中國國民黨
高雄市鳳山區鳳東里,-954,800,1754,4646,6325,0.7,蔡瑋寧,民主進步黨
高雄市鳳山區龍成里,-713,297,1010,2119,2981,0.7,張芳瑋,無
高雄市鹽埕區中原里,-129,55,184,440,592,0.7,洪玄志,無
高雄市鹽埕區中山里,-429,156,585,948,1323,0.7,易明忠,無
高雄市鹽埕區光明里,-469,6,475,44,70,0.6,葛吉雄,無
高雄市鹽埕區南端里,-315,92,407,656,946,0.7,陳清標,無
高雄市鹽埕區博愛里,-217,45,262,482,657,0.7,林哲弘,無
高雄市鹽埕區壽星里,-234,115,349,872,1286,0.7,黃強,無
高雄市鹽埕區府北里,-242,200,442,1414,2000,0.7,林傳富,民主進步黨
高雄市鹽埕區慈愛里,-132,34,166,262,372,0.7,呂佳穎,無
高雄市鹽埕區教仁里,-416,202,618,1436,1919,0.7,許富仁,民主進步黨
高雄市鹽埕區新化里,-239,65,304,445,588,0.8,夏麗鳳,無
高雄市鹽埕區新樂里,-207,88,295,627,833,0.8,黃昭翔,無
高雄市鹽埕區新豐里,-216,86,302,598,818,0.7,郭蘇元,無
高雄市鹽埕區江南里,-201,44,245,416,602,0.7,蔡德龍,民主進步黨
高雄市鹽埕區江西里,-414,99,513,751,1045,0.7,鄭錫國,無
高雄市鹽埕區沙地里,-243,67,310,518,717,0.7,高健財,無
高雄市鹽埕區河濱里,-496,190,686,1170,1542,0.8,林德松,無
高雄市鹽埕區港都里,-345,81,426,774,1042,0.7,邱誌雲,民主進步黨
高雄市鹽埕區瀨南里,-151,49,200,432,591,0.7,邱有洧,無
高雄市鹽埕區育仁里,-278,65,343,558,786,0.7,葛有力,無
高雄市鹽埕區藍橋里,-258,166,424,955,1281,0.7,陳本興,中國國民黨
高雄市鹽埕區陸橋里,-362,111,473,785,1109,0.7,許梅娟,民主進步黨
高雄市鼓山區光化里,-323,122,445,869,1232,0.7,周國城,無
高雄市鼓山區光榮里,-500,375,875,2488,3401,0.7,葉文朗,無
高雄市鼓山區內惟里,-342,136,478,802,1114,0.7,林進發,無
高雄市鼓山區前峰里,-1224,430,1654,2903,3958,0.7,盧明惠,中國國民黨
高雄市鼓山區厚生里,-799,342,1141,2101,2871,0.7,歐瑞清,無
高雄市鼓山區哨船頭里,-221,100,321,696,984,0.7,楊宗正,無
高雄市鼓山區壽山里,-427,121,548,875,1290,0.7,陳進興,民主進步黨
高雄市鼓山區寶樹里,-369,111,480,831,1941,0.4,王登科,無
高雄市鼓山區山下里,-347,143,490,952,1285,0.7,杜文瑞,中國國民黨
高雄市鼓山區峰南里,-370,52,422,531,774,0.7,王宋金花,中國國民黨
高雄市鼓山區平和里,-1114,356,1470,2496,3335,0.7,陳玉芳,民主進步黨
高雄市鼓山區延平里,-250,71,321,550,734,0.7,洪蔡愛玉,無
高雄市鼓山區建國里,-335,287,622,1860,2438,0.8,林福祥,無
高雄市鼓山區忠正里,-1151,392,1543,2602,3591,0.7,洪吉祥,無
高雄市鼓山區惠安里,-367,122,489,763,1087,0.7,洪進成,無
高雄市鼓山區新民里,-354,92,446,709,973,0.7,洪宗郁,無
高雄市鼓山區明誠里,-2806,2085,4891,10426,14752,0.7,胡景森,中國國民黨
高雄市鼓山區桃源里,-179,53,232,409,552,0.7,李慶賢,無
高雄市鼓山區樹德里,-437,110,547,852,1120,0.8,黃武田,無
高雄市鼓山區正德里,-680,192,872,1441,1972,0.7,朱榮俊,中國國民黨
高雄市鼓山區民強里,-699,242,941,1861,2549,0.7,歐華美,無
高雄市鼓山區民族里,-587,155,742,1032,1338,0.8,朱春木,中國國民黨
高雄市鼓山區河邊里,-378,6,384,42,61,0.7,曾茂信,中國國民黨
高雄市鼓山區登山里,-295,64,359,425,633,0.7,許永堃,無
高雄市鼓山區綠川里,-388,130,518,984,1326,0.7,郭國華,無
高雄市鼓山區維生里,-447,109,556,846,1193,0.7,董錦昌,無
高雄市鼓山區自強里,-276,63,339,561,787,0.7,方紹義,中國國民黨
高雄市鼓山區興宗里,-520,100,620,875,1239,0.7,楊孟翰,無
高雄市鼓山區華豐里,-579,485,1064,2975,3986,0.7,黃明洲,中國國民黨
高雄市鼓山區裕興里,-621,418,1039,2532,3407,0.7,曾榮發,中國國民黨
高雄市鼓山區裕豐里,-930,313,1243,1969,2704,0.7,周恆功,中國國民黨
高雄市鼓山區雄峰里,-263,247,510,1338,1958,0.7,楊惠茵,中國國民黨
高雄市鼓山區麗興里,-306,85,391,657,953,0.7,王志斌,無
高雄市鼓山區鼓岩里,-357,100,457,777,1150,0.7,方國智,無
高雄市鼓山區鼓峰里,-601,253,854,1345,1910,0.7,麥克士,中國國民黨
高雄市鼓山區龍井里,-302,116,418,906,1265,0.7,周明吉,無
高雄市鼓山區龍子里,-2076,2227,4303,11497,15711,0.7,蘇彥傑,無
高雄市鼓山區龍水里,-4531,3308,7839,16567,22489,0.7,初學霖,民主進步黨
